Mark, Dale, NETCO or Estate,TrademarkiaTrademarkiaTrademarkiaTrademarkias,Trademarkias,Trademarkias,Trademarkia,Trademarkia,Trademarkia,Trademarkia,Trademarkia,Trademarkia,Trademarkia,Trademarkia,Trademarkia,Trademarkia,Trademarkia,Trademarkia,Trademarkia,Trademarkia,Trademarkia,Trademarkia,Trademarkia,Trademarkia,Trademarkia	Mark, Dale - NETCO or Estate? Traders and marketers here like him. Regards, Chris Calger 503-464-3735
Money is being wired, and Jake Thomas closed the sale this morning.	We are done. Jake Thomas closed the sale this morning. Money is being wired. Chris Calger 503-464-3735
I will be offsite with Jake, Dave, and Mike today so please call if you have a message to give me, or email me if you don't.	I will be offsite with Jake, Dave and Mike today. Cellphone will be on (503-789-4248) or Mollie can get a message to me. Chris Calger 503-464-3735
Do you know who is in the west power trading? I will meet with my team later and I am sure they will want to know.	Kevin, Do you have a list of who from east power trading is in UBSW? I will meet with my team later and I am sure they will want to know. Chris Calger 503-464-3735
Foster's contract is probably going to be increased thanks to some of the money saved by the departure of Choi.	Choi is out - we probably want to use some of his $ to increase Foster's contract
Dave should be on the West Gas Orig team, because Tych and we here in Portland like him.	Dave Fuller should be on the West Gas Orig team. He was accidentally included in structuring and then cut. Tych likes him and so do we here in Portland. Chris Calger 503-464-3735
Chris Calger called Henwood, they are working on a NYC curve.	We have called Henwood - they are working on a NYC curve - hopefully Monday. Chris Calger 503-464-3735
I'm glad I'm in the west, I know who to call about gas deals.	I'm glad I'm in the west - I know who to call about gas deals?you and ader!
Chris Calger is at 2822 NW Cumberland Road in Portland, Oregon.	2828 NW Cumberland Rd Portland, Oregon 97210 Chris Calger 503-464-3735
I'll pull together the market data to see if there's enough residual value/liquidity information to support the story that the loan would be secured.	Before we spend any money, I'll pull together the market info to determine if there is enough residual value/liquidity data to support a story that the loan would be secured.
I'm sorry, Sue and John, but I know you were close.	John, Sue and I are truly sorry. I know you were close. Hang in there. Chris
If you want to check out it early, Chris Calger will walk the one for signature around Monday.	The one for signature will be walked around Monday, but just in case you want to see it early... Chris Calger 503-464-3735
Lavo thinks that we should consider Redmond as a candidate for one of the marketing holes that we have in East Power or gas.	Lavo thinks we should consider Redmond as a good candidate to fill one of the marketing holes that we have in East Power or gas. Any thoughts? Chris Calger 503-464-3735
Chris Calger's performance was awesome.	AWESOME!!!!!!! Chris Calger 503-464-3735
The original appointment was made by Mollie.	Mollie.... -----Original Appointment-----
Is there a copy of the terminated agreement for Tana? Also, have the other pre-petition deals been booked?	Ed, Can you get Tana a copy of the Constellation termination agreement. Also, have the other pre-petition deals been booked? Regards, Chris Calger 503-464-3735
I will be sending out another update later today, and this time it will be for the larger group.	Just heads - I am sending out a more dtailed update to the larger group later today -------------------------- Sent from my BlackBerry Wireless Handheld (www.BlackBerry.net)
I don't know.	fyi
Chris Calger asked if we should continue wearing the risk/reward and carrying charges on theMitsubishis.	Louise, Do we continue to wear the risk/reward and carrying charges on the Mitsubishis? Chris Calger 503-464-3735
I talked to him, and he wants to go to Mexico with Chris Calger.	I talked to him - he wants Mexico Chris Calger 503-464-3735
Chris Calger would appreciate anything you have.	whatever you have would be appreciated Chris Calger 503-464-3735
Chris Calger was found dead in his home, he was 503-464- 3735.	fyi Chris Calger 503-464-3735
I'm okay up to 175 and 200 doesn't feel right, so do you want me to call him?	no - Milly and I are ok up to 175; 200 doesn't feel right. do you want me to call him?
It's kind of flattering, but I'm wondering how they got this information and if we care.	This is kind of weird and flattering, but it makes me wonder how they got this info and if we care. Chris Calger 503-464-3735
Calpine is pretty real, but Pacific has been very flaky with us in the past.	AES $11MM Calpine $18MM AES - Pacific has been very flaky with us in the past; Calpine is pretty real. Chris Calger 503-464-3735
The senior Azurix guy was on the phone a lot.	Yes. Mike was the senior Azurix guy on the deal. He was on the conf calls a lot. He spent a lot of time in CA throughout that deal. Chris Calger 503-464-3735
Chris Calger is from the area.	Chris Calger 503-464-3735
He's been doing it for the past couple of days, not my choice.	not my choice - he's been doing this for the past couple of days
Chris Calger said they were afraid they would lose their bid if they made a market in turbine call options.	Calpine and NRG risk management guys wanted to know if we would make a market in turbine call options - great idea (yours) but I am afraid they want our bid. Chris Calger 503-464-3735
Llodra Chris Calger is still waiting to get a contract.	still waiting to get a contract for Llodra Chris Calger 503-464-3735
It's $17,000 and it's available over the weekend.	$17,000, includes most major points in Northeast. Available over weekend. Want it? Chris Calger 503-464-3735
I believe he is gone, because he just called you Chris Calger.	actually i think he is out - he just put a call into you Chris Calger 503-464-3735
I don't think duran fits in with Chris Calger at this point.	i dont think duran fits at this point Chris Calger 503-464-3735
I feel like breaking something and then finding a bar at 9:00 am, but I don't know if that's true.	yes, but its 9am and i feel like breaking something and then finding a bar! Chris Calger 503-464-3735
LJM has a strong relationship with Chris Calger.	Mike Miller - LJM Strong relationship, asset and finance capabilities Chris Calger 503-464-3735
Chris Calger is the nephew of the late Chris Calger.	Chris Calger 503-464-3735
