I think this looks better and we're going to proceed with advertising once I hear back from you.	Rick -- I think this looks much better. We'll proceed with advertising once I've heard back from you. Thanks for your input. Lisa
Is it possible for everyone to have a conference call tomorrow with Ken?	Does 4 central work for everyone for a conference call tomorrow with Ken?
Les and Jeff would like to speak toLisa when they can.	Les & Jeff: I'd like to set up a short call today to discuss the Sempra pipeline. When are you available? Lisa
If there's no flexibility, that's fine, as long as it's possible to move it up to November 1.	Any flexibility to move it up to November 1? If there's no flexibility, that's fine.
Sue and Jim, this is the documents that I prepared for you in connection with the issues that we just talked about.	Sue and Jim: Here are the documents that I prepared in connection with the issues that we just discussed.
I'm trying to figure out if there's any difference between the number of transactions that occur on EOL compared to the number of transactions that occur on the other platforms.	Andy: Who heads up your fundamentals group? I am trying to get my arms around the number of transactions that occur on EOL compared to the competing platforms (for power and gas). Thanks. Lisa
Rick and Maggy met with Jeff McMahon earlier in the week and they are helping Julia with this.	Rick: This is what Maggy and I have been helping Julia with lately. We met with Jeff McMahon on this earlier in the week. FYI.
Our new cfo was named.	was named our new cfo!
President Bush's statement was read by Larry Decker.	President Bush's statement on 201. Larry Decker 06/05/2001 04:37 PM
If you need more information, please let me know.	Steve -- Here it is! Let me know if you need additional information. -Lisa
I will keep a close eye on this, because it is something we need to keep a close eye on.	FYI. This is something we need to keep a close eye on, and I will do so. Lisa
Rick, I am forwarding information that I gave to you last week, please let me know if you have any questions.	Rick: Jim said that you were asking about this deal. I'm forwarding the information that I provided to you last week (in hard copy), FYI. Let me know if you have any questions. Lisa
Rick isn't sure if the Law Conference should count, but it's Lisa's call.	Rick: I'm not sure the Law Conference should count, but it's your call. Lisa
We should talk about this at some point, because our international trading business is growing by leaps and bounds, and I need to put in place systems to make sure it doesn't get out of control.	Rick: We should talk about this at some point. Our international trading business is growing by leaps and bounds, and I am trying to get systems in place to manage this BEFORE it gets totally out of control. Lisa
Attached is an estimated budget for 2002 for Rick and his wife, Lisa.	Rick: Attached is my estimated budget for 2002. Lisa
I'll be meeting with McMahon on Monday.	FYI, for meeting w/ McMahon on Monday. Lisa
This is the latest version that I have.	Here is the latest version that I have. Lisa
Rick should give you an idea of the kind of information these groups are looking for.	Rick - again, to give you an idea of the kind of information these groups are looking for. This was prepared by Masha. Lisa
Sue and I decided you must have been happy with the success of your carrot comments, because Rick and I both loved them.	Rick: I loved, loved, loved your comments about Southern Company. Sue and I decided that you must have been feeling empowered by the success of your carrot comments!!!!
It is said that southern is the most potent of the Neanderthals.	something about southern being the most potent of the Neanderthals!!
That's correct.	FYI
Have you seen anything like this before?	Holy cow. Have you ever seen anything like this? Lisa
There was some interesting feedback on Enron's entry into the steel market.	Some interesting feedback on Enron's entry into the steel market. Hope you're enjoying your vacation. Lisa
Thank you, Jeff, for taking care of this inquiry, I'm on vacation this week.	Jeff: I am on vacation this week. Can you take care of this inquiry? Thank you - Lisa
I was hoping that it could be next Friday, but Rick did not ask about it when we talked this morning.	Rick: I forgot to ask you about my last day when we talked this morning. I was hoping that it could be next Friday? Is that possible? Thanks, Lisa
Do I have to set up a meeting with JoAnn Hill?	rick: do I need to set up a meeting with Joann Hill?
We were looking at these before lunch and they were touching.	Sue and I were looking at these before lunch. They are very touching. Lisa
Please review and provide me with your suggestions. After you are comfortable with this, I will circulate to the larger group.	Mark: Please review and provide me with your suggested changes. Once you're comfortable with this, I will circulate to the larger group. Thanks. Lisa
Mark, do you have time this afternoon or tomorrow morning to discuss this with me?	Mark: Do you have time this afternoon or tomorrow morning to discuss this with me? THanks, Lisa James D Steffes 06/07/2001 12:34 PM
Mark, when you get back to the office, let's talk about this.	Mark -- let's talk about this when you return to the office. thx. Lisa
ICE and LCH have announced clearing services for OTC products.	FYI - ICE/LCH announcement introducing clearing services for OTC products...Lisa
There is something to be said.	FYI.
We've been working on the new GTC with Legal and commercial, it's getting closer to a final product.	Here it is!! This is the new GTC that we've been working on with Legal and commercial. It's getting closer to a final product. FYI. Lisa
I have sent the President's Energy Report on coal to the coal group.	Mike/Jeff: FYI, the section of the President's Energy Report on coal. I have sent this to our coal group as well. Best regards, Lisa
Chris is looking into if he has the votes after the good Senator asked the Senate Finance committee to initiate a 202.	Rick: FYI. The good Senator is making good on his promise to ask the Senate Finance committee to initiate a 201. Chris is looking into this to see if he has the votes. Lisa
Ken, I was thinking about asking you to prepare this for us, but do you have any trouble with that from your end?	Mark: It would be helpful to have a "regulatory maxtrix" showing which agency has responsibility for what. I was thinking of asking Ken to prepare this for us. Any problem with that from your end? Thanks. Lisa
Are we allowing racicot to go?	are we letting racicot go? (see reference to him below)
Is this something you can help me with since you do not have anything else going on in California, or should I send it to the enviro group?	Jeff - is this something that you can help me with (since you don't have anything else going on in California!!!), or should I direct it to the enviro group? Thanks, Lisa
Between now and November 12th, we should schedule a time to go to lunch.	Jim: We should schedule a time to go to lunch between now and November 12th. - Lisa
Rick, I wanted to tell you about the types of information that we're giving to EIM.	Rick - I wanted to give you a flavor of the kinds of info that we're providing to EIM. Masha put this together. Lisa
Rick and Elizabeth, if you have any questions, let me know.	Rick and Elizabeth: Below are my budget spreadsheet scenarios for EIM, EGM and ENW. I have broken the budgets down by business unit. Let me know if you have any questions. Lisa
I'll distribute the steel study tomorrow when I get the article.	Chris - I will forward the article to the steel distribution (jeff already has it). I will distribute the steel study tomorrow when I receive it. Thanks, Lisa Chris Long 04/30/2001 10:07 AM
Let me know if you want a follow up discussion today or tomorrow.	Rick: When do you want to have our follow up discussion from last Friday? Today or tomorrow? Let me know what works for you. Lisa
Steve thought that you might want to see how we're working on the issue in Maryland. Rick and Joe were copied on the original message.	Steve: Thought you might want to see how we're pursuing the "transmission equality" issue in Maryland. Rick and Joe were blind copied on the original message. Hope you're doing well. Lisa
We had a meeting this morning.	Following up from our meeting this morning, FYI. - Lisa
