Maybe Kathy for gas, Steve for electricity, or Rick for electricity.	Maybe Kathleen for Gas and Steve or Rick for Electricity. Fiona Grant is primary contact, Kim Chandler is backup contact.
I would like to keep my subscription up-to-date.	I want to keep my subscription current.
This is an interesting idea, but I don't think it's worth the paper it's written on.	This is an interesting idea.
If that's the case, please add Linda Robertson to this list.	Please add Linda Robertson (Head of our DC office) to this list if that's ok. Sally Keepers 05/04/2001 03:04 PM
It looks good to me, Jeannie. I'm glad you had the chance to work with Linda.	Looks good to me. I'm glad you had the chance to work with Linda. Jeannie Mandelker@ECT 05/23/2001 03:31 PM
Send out a note about the meeting if you put it on the distribution list.	include on the distribution list and send out note about the Monday meeting.
The market power of Linda Breathitt and Jordan Mintz will be discussed in Claif tomorrow.	Claif Briefing tomorrow US GEN market power Linda Breathitt Jordan Mintz 3-7897 Allegretti
Are we able to capture these "accelerations" in our accomplishments?	Will we capture these "accelerations" in our accomplishments?
Rob is asked to look into it, I think this is something we should consider.	I think this is something we should consider. I'm asking Rob to look into it. "Gilbert R. Whitaker, Jr." <grwhit@rice.edu> 11/16/2000 02:06 PM
There is a calendar.	calendar
Please give Pam the information for Joe on where to send the check and who to send it to.	Please send Pam Benson the information for Joe on where to send the check, who to make it out to , etc
Karen Owens thinks you should talk toRosalee.	Sorry, I think you should talk directly with Rosalee. Karen Owens@EES 02/27/2001 01:05 PM
It can be printed on a piece of paper. It can be printed on a piece of paper.	print
I'd like to get in touch with Amy and I need her e-mail address.	Please give me Amy's e-mail address. I'd like to get in touch with her. Thanks. Emily Sellers 02/06/2001 01:16 PM
There is a Committee on Regional Electric Power Cooperation in the state of Arizona.	Committee on Regional Electric Power Cooperation, in Tempe, AZ
Enjoy your vacation, Jeffrey, no need to do anything right now.	Thanks anyway. no need to do anything right now. enjoy your vacation. Jeffrey Keeler 06/18/2001 01:10 PM
I'll be able to attend.	I will attend.
We should include the VP of human resources, David Oxley.	We should include David Oxley -- VP of human resources.
On July 27th, 2000 12:02:47 PM, Gary Fitch@ENRON, you were the winner!	Congratulations! Gary Fitch@ENRON on 07/27/2000 12:02:47 PM
More detailed information about what's going on.	more detailed information
Yes, lyoho@enron.com.	yes lyoho@enron.com 09/26/2000 09:03 AM
It is not possible to tell whether it is fyi or not.	fyi
The meeting file is for a meeting.	meeting file
Any interest?	Any interest?
I don't know if I have already signed or if I haven't, but I couldn't open the link.	I couldn't open link. I s this something new for me to sign or have I already complied?
What kind of interest do you have?	any interest?
Please deal with it.	Please handle
My suggestions are attached.	Attached are my suggestions.
The Cynthia Sandherr Subcommittee is going to mark up on October 13 according to Stan Broussard.	Stan Broussard 3-5468 Cynthia Sandherr Subcommittee going to mark up on Oct 13
The direct access decision was put back until August, but you've probably heard about it already.	You have probably heard this already, but on July3, the CPUC postponed their direct access decision until mid-August. Dan Leff@EES 07/02/2001 07:15 AM
Please send if it hasn't yet gone to Ken.	Has this gone to Ken yet. If not please send. Maureen McVicker 06/21/2001 02:55 PM
Please let Don know if there is a problem.	Any problem? please advise Don.
If you can provide a response, I'd like to know what to do with it.	Hap -- could you provide a response and get it to Meredith. I'd like to correct this.
I have received a confirmation of my regrets from Horton and Metts.	I have also received regrets from Horton, but confirmation from Metts
EB 4712C is located in the eastern part of the United States.	EB 4712C Ext. 3-1586
Please let Paul know that the plan was for the issue to be in the short format of Ebiz and in the longer format of the October issue of Enron Business.	The plan was to hit the issue twice -- once in the short format of Ebiz and at greater length in the longer format of the October issue of Enron Business. Please let Paul know.
Thanks to Ken Rice, of Aron Communications, for the oops, 11/08/2000 08:33 AM.	oops -- thanks Ken Rice@ENRON COMMUNICATIONS 11/08/2000 08:33 AM
There are more signs that the power angle may be fruitful.	More indications that the power angle may be fruitful
Peter Styles should be signed by Mike.	I think Mike should sign Peter Styles@ECT 04/20/2001 04:57 AM
Lauren KellyKimberly@enron communications was the person who said that their accomplishment was outstanding.	Outstanding. Congratulations, Lauren Kelly Kimberly@ENRON COMMUNICATIONS 02/27/2001 03:53 PM
Linda, I've never heard of them. Are you aware of them?	Linda - I haven't heard of these guys. Do you know them?
PerGeoff Roberts.	Per Geoff Roberts
The Junior League by the Ritz starts at 12:00 and there is an Enron table in the parking garage.	Junior League, by the Ritz, starts at 12:00, there's an Enron table, buffet line. Parking garage is adjacent to the Junior League.
You speak at 3 in the afternoon.	You speak at 3:00
On Wednesday, I will be out of the country.	I will be out of the country on Wednesday Johan Zaayman@ENRON_DEVELOPMENT 10/10/2000 02:50 PM
Linda Robertson was the winner on July 19th 2001 09:44 AM.	Congrats Linda Robertson 07/19/2001 09:44 AM
I don't know.	fyi
Montano or Day Presentation can be called to give a presentation to the MIT group Texas file.	Call Montano or Day Presentation to ECT presentation to MIT group Texas file, cal file
Attachments.	attachments
The calendar has a month.	calendar
A statement is attached to open the Executive Committee meeting on Monday.	Per my voicemail, attached is a proposed "statement" to open the Executive Committee meeting on Monday.
Randy Rich is in town.	Randy Rich in town
800-998-2462 is what you will get when you click on the pin code.	Call 800-998-2462, pin code #629012
We're going to meet with the gov in LA tomorrow at 3:00. I'll let you know how it goes, if it goes at all.	We are now scheduled to meet with the gov. tomorrow in LA at 3:00. I'll let you know how it goes (if it goes).
We don't know yet because he has been invited and we expect most will show up, but we won't know until they do.	We don't know yet. He has been invited and we expect most will show up, but we won't know until they do. Enron Energy Services
MIT wants to speak to us about energy procurement and management, can you let someone in touch with them?	See last point: MIT would like to talk to us about energy procurement and management. Could you put someone in touch with them?
Joe and Linda, if you could give us a heads up about these two, we would forward our views to Ken.	Joe and Linda, could you prepare our views on these two and forward to Ken?
It's a thing of the past.	fyi
I would like to be on the more detailed management report as well.	Thanks. Please keep me on the list for the more detailed management report as well. Leonardo Pacheco 09/21/2000 05:36 PM
It's late and you have to fly to New York.	Fly to New York late.
The schedule has a bunch of things on it.	schedule
I will be back in the evening and then in the morning, so if you want me to come by, give me a call.	I will be getting back from Washington late today, but will be in early in the morning (evening your time). Give me a call Nicholas O'Day 11/06/2000 03:41 AM
Maybe we should think about putting something together on India.	Perhaps we should consider putting something together on India?
We don't know if we have a chance of getting final approval at the meeting.	What are our chances of final approval at FERC at the JUly meeting. Jeff still thinks this is a third quarter close. Do we have any chance of making that happen?
Mark's organization is correct on this one.	Ricardo -- Mark's organization is on point on this one.
Please put someone in touch with Chris because I am going to copy him.	I am going to copy Phillippe Bibi (Chief Technology Officer) and Cindy Olson (EVP-HR). Please put someone in touch with Chris. Thanks
Barb, thanks for your kind words.	Thanks, Barb. Barbara A Hueter 11/03/2000 02:15 PM
Binky Davidson, of theEES, asked if it would be possible to insert the attached after hearing the explanation about the relationship between New Power and Enron.	How about inserting the attached (after the explanation about the relationship between New Power and Enron)? Binky Davidson@EES 03/15/2001 05:35 PM
Excellent work, Mike.	Nice work, Mike
I would be more than happy to speak to Nickles.	I'd be happy to call Nickles.
Nancy_Siska@cargill.com would be happy to help and learn.	I'd be happy to help and learn. Hve your assistant call Maureen McVicker 713.853.1808. Nancy_Siska@cargill.com 01/11/2001 12:01 AM
I'm not sure if that's true.	fyi
If you can locate the contact, you can check to see if they are still interested in the money.	can you find the contact and see if they are still interested in the money?
Contact Linda to finalize Alan Comnes@ECT.	Work with Linda to finalize Alan Comnes@ECT 02/06/2001 05:44 PM
Is it possible that you'll be filling out mine?	Will you be filling out mine?
As discussed, that's as much as it's boiled down to.	As discussed.
I'd like to know if you can look into this for me.	could you look into this for me?
I thought we were going to do both, but I think you're right.	I think you are right. I thought we were going to do both. Elizabeth Tilney@EES 06/13/2001 04:51 PM
I am very appreciative of your help preparing for the Texas hearing, I think the Texas legislators see the California experience in the proper context and that I was at least marginally articulate on the emissions issues as well.	thanks for your help in preparing for the Texas hearing. I think Texas legislators are viewing the California experience in the proper context and I think I was at least marginally articulate on the emissions issues as well. thanks again.
We may be able to handle it outside the policy committee, but it would be a good idea to have another discussion about it.	We may be able to handle this specific issue outside the policy committee, but I think it would be a good idea to set the next one anyway. I'm sure we'll have something we'll need to talk about.
Figuring out how to get something done.	Skilling
The speech was written by Sen. Hagel and focused on oil but also did a nice job of framing the importance of sound energy policy to our continued economic growth.	attached is Sen. Hagel's energy speech. He focusses on oil primarily but also does a nice job of framing the importance of sound energy policy to our continued economic growth.
We have been doing very well in the press, and we are not going to convert them.	I agree with John's recommendations. We have been doing surprisingly well in the press. And, for the most part, those who write bad stuff are doing so based on ideology ... we are not going to convert them.
I need some time with Shawn Cumberland, please schedule that as well.	Thanks, I also need to get some time with Shawn Cumberland... please schedule that too. Christopher B Hunt@ENRON_DEVELOPMENT 11/20/2000 11:03 AM
The voltage upgrade issue is being addressed by an individual named Maureen Palmer.	Ashok? Maureen Palmer -- Voltage upgrade issue
The guest list is fairly senior, so let Amy know if you'd like to attend.	This looks like a run-of-the-mill conference except that the guest list is fairly senior. Any interest? If not, let Amy know.
Don't give up on linda ro the recommendation.	Stay in touch with linda ro the recommendation.
There are changes to the revisions.	revisions
Lunch will be served, and can be found in Bill Hogan's office.	(Connie Burns in Bill Hogan's office 617-495-1318) Lunch will be served.
Call if you want to discuss the same thing that I did when I talked to her.	I talked to Peggy and her messages seem to be the same as ours. Call if you want to discuss.
Testing the Notes capabilities of the computer you use at home.	Testing Notes capabilities of your Enron home computer.
I will fax my comments to you, but I won't be on the call.	I won't be on the call, but will fax my comments to you this am Twanda Sweet@ECT 10/06/2000 09:51 AM
Contact Eric Hirst at Eric@EHirst.com if you have any questions.	Contact Steve Walton =09Eric Hirst <Eric@EHirst.com> =0911/10/2000 10:03 AM =09=09=20 =09=09
She should be calling you once the inauguration is over, that's what I left a voicemail for.	I left a voicemail for Rosalee. She should be contacting you once the inaug. is over. Linda Robertson 01/18/2001 05:04 PM
I think wholesale will be covered.	I think wholesale will be well covered. Enron Capital & Trade Resources Corp.
I would appreciate it if you could include Human Resources and add some additional information about Enron in my bio.	Please update my bio to include Human Resources and add some boilerplate on Enron.
This is an issue we need to keep an eye on.	This is an issue we need to stay on top of. Felicia: could you please put= =20 some background together for everyone on the list?
Maya Weber and Joe Hillings are married to Steve Montovano.	Maya Weber 202 383 2260 Joe Hillings Steve Montovano
John Anderson, Brad Petzold, and John Henry are all part of the PTC/NERC.	John Anderson PTC/NERC Brad Petzold Power Nav -- John Henry (202) 466-0547
Mary was attached to the attached statement: "You can see attached statement by Stacy Guidroz@enron_DEVELOPMENT 09/22/99 09:36 PM."	Mary -- see attached Stacy Guidroz@ENRON_DEVELOPMENT 09/22/99 09:36 PM
The summary of yesterday's meeting was attached by Susan J Mara.	Summary of yesterdays meeting attached Susan J Mara 01/14/2001 01:16 AM
Gordon Weil, Joe Allen and Dave Marquart are all related.	Gordon Weil Joe Allen Dave Marquart Richard Tabors
I don't know what to make of it.	fyi
I will defer to you on this, but it doesn't seem like a priority to me.	Cynthia, get back to Jeff on this. It doesn't look like a high priority to me, but I will absolutely defer to your judgment.
There is no reason to stop the presses.	My mistake, but no reason to stop the presses.
, Palmer.	, Palmer
I spoke with Scott and he understood your concerns, so I don't think there is anything else you need to do.	I talked with Scott Tholan and he immediately understood your concerns. I don't think there is anything else you need to do right now. Let me know, though, if there are requests for information you consider inappropriate.
Was this-8873-8873-8873-8873-8873-8873-8873-8873-8873-8873-8873-8873-8873-8873-8873-8873-8873-8873-8873-8873-8873-8873-8873-8873-8873-8873-8873-8873-8873-8873-8873-8873-8873-8873-8873-8873-8873-8873-8873-8873-8873-8873-8873-8873-8873-8873-8873-8873-8873-8873-8873-8873-8873-8873-8873-8873	Wow! Was this expected? Sarah Novosel@ENRON 07/19/2000 03:52 PM
I don't think LexiElliott is a good fit.	I don't see a fit Lexi Elliott 02/28/2001 02:39 PM
I assume you have already had communication with Marty about this, since Scott sent this to him.	Scott sent this to Marty, but I assume you already have had communications with him about this.
Jimmy was left off of the note but I am sure he is doing a good job.	Thanks. Look forward to seeing you. Sorry I left Jimmy off the note, I know he must be doing a good job. John Ambler@ENRON_DEVELOPMENT 03/23/2001 10:11 AM
You have to be there by noon to attend the meeting.	Need to be there by noon to attend Ashok's staff meeting. Fredericksburg A room Your Continental flight leaves at 9:45.
I agree with Karen that the copy needs to be changed, since the gas market is blowing up.	I agree that we need to rework the copy, especially since the gas market is blowing up. Karen Denne 12/04/2000 12:33 PM
The person who works for Beth Tilney is the head of HR, not the person who works for EES.	FYI -- Kalen is the head of HR for EES; she works for Beth Tilney.
You can speak at Affirmatively at 1:10 Central time.	You speak at 1:10 Central time.
Let me know when and where it is.	Let me know when and where.
Call Mary Kay if you want to put FH on the AAE retainer meeting on Sun in Bd Rm at 8:00am.	Put FH on AAE retainer Bd Meeting on Sun in Bd Rm at 8:00am Mary Kay -- posi'n on TW: ROW issues; call Leslie
Is there a way you could get the information to cathy?	Could you work with Allison to get the needed information to cathy.
Thanks for the offer, I might be able to take you up on it.	Thanks for the offer. I may take you up on it. Martin Bucknell/ENRON@enronXgate 03/27/2001 06:21 PM
202-586-3093 to discuss the meeting on June 3.	to discuss June 3 meeting. 202-586-3093.
I didn't sell anything, right?	I didn't sell any, right?
I hope we get there soon.	Thanks, I hope we get there soon. Mary Clark 09/26/2000 01:55 PM
Send a description of the topic and an estimate of time to Rebecca.	Please send an estimate of time and description of the topic to Rebecca.
There is a meeting with Commissioner Ebert scheduled for 7/1/97 in Biloxi.	Meet with Commissioner Ebert in Biloxi - Confirmed 7/1/97 Contact is Paige - 601-436-4833
Please check the schedule and respond as soon as possible.	Please check schedule and respond
It is good to keep track of if we want a point of contact.	No special requirements, but it's good to keep track of in case we want a point of contact. Thanks John Wack@EES 09/22/2000 05:05 PM
The Livingston Room is located at the Four Seasons Hotel.	At the Four Seasons Hotel - Livingston Room
I'll be more than happy to talk to you at 713.853.1586.	Feel free to call me at 713.853.1586.
The presentation I used for a general update on deregulation includes some California material.	Attached is the presentation I used for a very general update on deregulation; it includes some California material.
We need to put together a book for Ken before he goes to California.	We need to put a briefing book together for Ken ASAP for his California trip.
I sent a copy of it to John Baker and I was wondering if you could email it to me so I could schedule lunch with him.	I sent an electronic copy to John Baker. Maureen could you send one directly to Jason and schedule lunch? thanks Jason Sokolov@ECT 11/17/2000 10:09 AM
I thought we'd heard it from 3 or 4 sources.	Is this it? I thought we had heard it from "3 or 4" sources. Enron Capital & Trade Resources Corp.
Sean, is this something that we need to follow up on?	Sean - is this anything we need to follow up on?
I do not.	I do not. Enron Energy Services
We are going to release this release today with some alterations, because we have settled and there was a lot of grief on the Hill when we had our fight with UC/CSU.	I know we got a lot of grief on the Hill when we had our fight with UC/CSU. Now we have settled and this release will go out (with some modification) today.
I'm not sure what I'm supposed to tell you. I'm not sure what I'm supposed to tell you.	fyi
Thanks for being on top of it, please let the HR team leaders know as soon as you can.	Thanks for getting on top of this. Please get the word out to the HR team leaders as soon as you know more.
I think the documents look great. I'll talk with Ken and Jeff after I've finalized a few outstanding items with them.	I think the documents look good. I will discuss with Ken and Jeff (after finalizing a few outstanding items with these individuals). John Ambler@ENRON_DEVELOPMENT 01/26/2001 03:34 PM
We understand that McKinsey may be assisting the Governor in creating a demand buy down program.	Thanks for the analysis. We understand that McKinsey may be helping the Governor develop a demand buy down program. Is this true?
Our friend Paul Carpenter seems to be talking nonsense, so how about giving him a call?	See natural gas price article below. Our buddy Paul Carpenter has turned o= n=20 us (not to mention that he seems to be talking nonsense). How about giving= =20 him a call?
Mark Palmer is reachable by phone on 09-26-2000 at 08:51 AM.	yes Mark Palmer@ENRON 09/26/2000 08:51 AM
I don't know.	fyi
You look like you are shaking up in typical Enron style, if you see the last story attached.	See last story attached. Congratulations, it looks like you are shaking th= ings up in typical Enron fashion.
We have to do a better job at this and can use the same technology that IR did.	We have got to do better at this. IR did a webcast of the annual meeting that from all reports had a minimum of glitches. Can we use the same technology? Courtney Votaw 03/13/2001 09:10 AM
Did your e-mail go to Oxley?	I saw your e-mail response. Did it go to Oxley too?
You will have an hour to speak if you address issues in OASIS, along with deregulation material.	Moved to 11:00 per Larry Trybus Please address issues in 889, OASIS, in addition to deregulation material You will have an hour to speak
We are going to discuss the California power situation at the 2:00 call today.	Attached is a summary of the Jan 13 Davis-Summers summit on the California power situation. We will be discussing this at the 2:00 call today.
I think Christi did a good job with the message. Check with her one last time and let it go.	I think the message Christi prepared is great. Check with her one last time and then let it go.
Yes.	Yes
Please get me Pat Wood's phone number so I can make a call to him as soon as possible.	Please get me Pat Wood's phone number and post a reminder on my calendar to call him ASAP
I can't remember if it was canceled or not.	CANCELLED......
You should get back to him in the second week of October.	Ralph Reed--get back to him (second week of Oct)
Excellent work, Laura!	Strong work, Laura!
Did you handle it already?	have you handled already?
Next week is the time to set up the meeting.	Set up meeting re Mt. St. Helens for next week
I think that's a good way to phrase it. I think that's a good way to phrase it.	fyi
I need to speak with you about the public message in India.	I still need to talk to you about our public message in India. I am on my way to Calgary tonight. My hotel number is 403-266-7331. Thanks.
Please let me know if you make any changes, or if you 888-492-0 888-492-0'd your answers to the questions in the text.	Attached is the draft. It combines all three announcements into one, with a common format. It reflects a "just the facts" approach. Let me know if you have changes (or answers to the questions in the text).
You have to test to know if it's a work of art.	test
Please have some time with Linda.	Please set up some time with Linda.
I'm not quite sure how it will all work out.	fyi
Contact Mike Terraso, who is in charge of the environmental function, and Mike Hicks, who is in charge of corporate security.	Contact Mike Terraso (who heads the environmental function) and Mike Hicks (who oversees corporate security). Jason Sokolov@ECT 10/11/2000 08:46 AM
Skilling on a company plane was what he came back with.	Came back with Skilling on company plane.
What are the appointments doing to you from your point of view?	How are the appointments turning out from your perspective?
I don't think this is worth the hassle of running a conflict of interest check to make sure no liability is taken for actions taken on the advice.	I doubt that this is worth the trouble (i.e. running it through a conflict of interest check, ensuring no liability for actions taken on the advice, etc).
Add Rob Bradley, peggy mahoney, and Mona Petrochko.	Add Mona Petrochko, peggy mahoney and Rob Bradley Gavin Dillingham@ENRON_DEVELOPMENT 08/25/2000 04:55 PM
It looks like there is a chance to explain price risk management to large customers.	Forward to whomever you see fit. It looks like an opportunity to explain price risk management to large customers.
Shirley should be included in your California updates.	please include shirley on your california updates
That's correct.	FYI
Aleck's changes indicate that the document should be revised.	Please revise the document as Aleck's changes indicate. With respect to the alternative responses shown near the end of the document, leave both alternatives in.
Mary Clark said that it's fine with her.	It's fine with me. Mary Clark 09/27/2000 11:23 AM
The OPIC has information.	OPIC information
Steve, take a look at it and contact the sponsor with a yes or no.	Steve - take a look at this and contact the sponsor with a yes or no. Thanks
Richard Shapiro was born on 2/26/2001.	yes Richard Shapiro 02/26/2001 01:34 PM
I think I confirmed this already, but you can check my calendar and put this in the meeting file.	I think I confirmed for this already, but could you check and put on my calendar and put this in the meeting file.
You can post on the internal site.	Please post on internal site
Ross Malme -- 7587 Anthony D.	Ross Malme -- 7587 Anthony D -- 6235
It is a bit lengthy but I think it looks good.	A bit lengthy, but I think it looks fine. Peggy Mahoney@EES 08/30/2000 12:41 PM
There is a calendar.	calendar -- FYI
How did this happen?	How did this happen?
David Rosenberg, Thank you for your kind words on 11/09/2000.	Thank you David Rosenberg 11/09/2000 07:35 AM
x35955 was submitted by Bobbie Moody.	Per Bobbie Moody, x35955
Linda Robertson was here on 3/01/2019 at 07:47 AM.	yes Linda Robertson 03/01/2001 07:47 AM
Ken has talked about EES willingness to invest in demand side management, if the right program were set up.	Ken has talked about EES willingness to invest this money in demand side management, if the right program were set up -- eg a demand buydown program. Leslie Lawner 02/13/2001 06:53 PM
Mark is sending his resume to community relations to see if there is interest in government affairs.	Thanks for the resume. I don't see a fit in government affairs, but I am forwarding to community relations to see if there is any interest there. Mark Courtney@ECT 10/12/2000 10:29 AM
I am wondering if Jeff is available.	Is Jeff available?
I'm still a junkie and I would appreciate it if you sent me copies of the orders.	I'm still a junkie .... please email copies of the orders.
My testimony is attached.	Attached is my testimony.
Per our discussion, that's how it is.	Per our discussion
Mary Clark Clarence is a reporter for the WSJ.	Reporter(WSJ) Ed Dardis UW - Mary Clark Clarence
The article I mentioned to you is referred to in the Firsst article.	Firsst article attached refers to the 1946 Nebraska case I mentioned to you= =20 in DC
Lou Pai and his sister know Franks very well, so if at some point we need to get in to see him, we should keep that in mind.	In case you had not heard, Lou Pai has done some fundraising for Franks and both he and his(Lou's) sister know him fairly well. Keep it in mind if at some point we need to get in to see him.
Please let us know if you schedule for Monday.	Please schedule for Monday
Do you think it's a good idea?	What do you make of this?
Per my phone call.	Per my voicemail.
Thanks a lot.	thanks
I don't know what I am talking about. I haven't figured it out. I don't know what I am talking about.	fyi.
Hey, you're referring to our future President, right? I'm looking forward to my next biennial resource planning proceeding.	Hey -- you're talking about our future President! I am soooo looking forward to my next Biennial Resource Planning proceeding.
The newly elected MDs should be added to the existing heading "Other Managing Directors".	Please revise by adding the newly elected MDs (from Friday's promotion memo) under the existing heading "Other Managing Directors". Thanks
There are recommendations for things to do.	recommendations
Do you follow the reports, do we need to correct them?	Do you guys follow these reports? Do we need to correct them?
There is a calendar.	calendar
It looks like a great letter and I'd like to hear more about what led us to this position.	It looks like a good letter.... heavy on explanation of our position. At some point I'd like to hear more of the background that's leading us to this position. Richard B Sanders@ECT 11/17/2000 10:19 AM
I have asked the question and should be able to answer it within a day or two.	Sorry for the delay. I have asked the question and should have an answer in a day or two. . . . don't do anything rash in the meantime. Jane M Tholt@ECT 05/07/2001 12:15 PM
Let Rick and Montovano know if you want to schedule a tour and make sure that Marchris is available.	per our discussion. Want to schedule a tour and want to make sure that Marchris is avail (let Rick and Montovano know)
Please bring the print copy with you to your next meeting.	please print
These were the last drafts before any changes were made.	These were the next to last drafts (before correcting any typos).
The last letter has a small change at the top of page 2.	Attached is the final letter. Please note - there was a small change at the top of page 2.
You can get the ball rolling by contacting either Gia or John.	Yes. Contact either Gia or John and get the ball rolling. Thanks Michael Terraso 08/18/2000 04:20 PM
I took a shot at a revised way of presenting the investment fund and the associated issues, but it may be too late for this afternoon.	Thanks. Look at the attached ... it may be too late for this afternoon, but I took a shot at a revised way of presenting the investment fund and the associated issues (substitute for slides 15-17?)
The meeting file and calnedar.	calnedar and meeting file
Please let me know if there are available dates.	Please get available dates. I need to be there for this.
Send an email to Elizabeth Labanowski, who will try Roy Boston in our office.	Try Roy Boston in our Hinsdale Ill office Elizabeth Labanowski@ECT Sent by: Elizabeth Labanowski@ECT 01/18/2001 09:27 AM
Is it possible to send a background email to Dave and I with any effect on us?	What's this about? Could you e-mail Dave and I with the background, any effect on us, etc.? Why was Dave on this distribution?
I'm looking forward to seeing you when you get back.	I'm envious. See you when you get back
Thank you!	Congratulations!
I think Ken left you a message, I have not heard from him in a while.	Ken did speak with Ulf (and I believe left you a message). I have not heard about further contacts as yet. Mark Schroeder@ECT 01/30/2001 04:37 AM
I agree with Sue's comments and have included her changes in this version of the letter.	I think this is an excellent letter. I agree with Sue's comments and have included her changes on Page 3. All changes have been marked in this version.
Is it okay with you?	OK with you?
We discussed it.	As we discussed
I'm not in until too late tonight, so I might have dinner or drinks on Thursday.	I get in too late tonight, but maybe dinner or drinks on Thurs? Linda Robertson 06/19/2001 06:39 PM
Tell him that we're going to send his note to an appropriate person.	Tell him we are sending his note on to the appropriate person. MARY CLARK 04/03/2001 03:23 PM
We want to know what they have done for us.	What have they done for us? Terence H Thorn@ENRON_DEVELOPMENT 10/03/2000 08:30 AM
Kathleen Lawner had the gas choice of Fumo3 and Peco 15.	houston Bryson? 3-6424 -- Peggy Menchaca Kathleen Leslie Lawner - gas choice Fumo3 (4,8,11,12,20) Peco 15 ( 39235 Lauren Cox 9416377899
Looks good, is it Maureen McVicker?	looks good Maureen McVicker 05/01/2001 05:36 PM
Looks good Elizabeth Peters.	Looks good Elizabeth Peters@EES 11/06/2000 08:27 PM
As we talked about it.	As we discussed.
They referred to siting that was expedited.	They refer to expedited siting. What are the provisions?
I will be sending a letter this week and you can speak from 10:15 - 11:00.	Want you to speak from 10:15 - 11:00 ** Will be sending a letter this week (3/19/97) Flew to Austin on company plane
These are usually a waste of time and money and you can respond to rob.kean.	These things are usually a waste of time and money. "Rob Kean" <rob.kean@worldnet.att.net> 01/13/2001 11:24 AM Please respond to rob.kean
This is the email that I was talking about.	This is the e-mail I was talking about.
I don't know what to make of it.	fyi
Prepare for my siganture.	prepare for my siganture. cc Lisa
You can find a backgrounder of Jeff's in the event you call him.	Attached is Jeff's backgrounder in the event you call Hertzberg.
Do you think it's a good idea?	what do you think?
The meeting file is for a meeting.	meeting file
Bill Hogan is at a birthday party tonight.	Maggie's Birthday party tonight Bill Hogan (617) 495-1317
The memo is going to be good to go after I agree with Mark's changes.	I agree with Mark's changes and I think the memo is good to go.
Jeff dasovich would like to be pre-empted.	Preempt me, please! Jeff Dasovich@EES 09/13/2000 06:22 PM
I think it's very important for our security people to be able to recognize our senior executives and make sure that their guests get where they are in a very short period of time.	These are good fixes. I still think it's important for our security people to be able to recognize all of our senior executives and make sure their guests get where they are going quickly.
Contact Dave Parquet and Jeff Dasovich if you're interested in working with them.	Contact Dave Parquet and Jeff Dasovich in our San Fran. office. Dave has worked on Enron's proposals to San Diego and Jeff has been supporting him from a gov't/reg affairs standpoint.
I haven't heard anything from Rosalee Fleming in over a year.	I have not heard Rosalee Fleming 11/20/2000 01:19 PM
Balboa and PGE filing have been canceled for the time being, and they'll call us when he gets back.	Balboa and PGE filing - Cancelled for the time being - per Vanessa Bob - They'll call us when he gets back
Has this been made available to the Cheney team?	Have we made this available to the Cheney team?
The lunch will be served at 11:30 and the QBR will start at 12:00.	Lunch will be served at 11:30, QBR starts at 12:00.
We have settled and this will go out today, we got a lot of grief on the Hill after the fight with UC/CSU.	I know we got a lot of grief on the Hill when we had our fight with UC/CSU. Now we have settled and this release will go out (with some modification) today.
Jim Ciconni is going to fly to Houston.	2:30 - 3:30 Jim Ciconni - Enron 4:45 Fly to Houston
I need a hard copy of cera. I don't have a password.	Need a hard copy ... I don't have a password for cera =09Eric Benson =0901/20/2001 10:02 AM =09=09=20 =09=09
I don't know.	fyi
I don't know what to make of it.	fyi
I believe it was intended for you.	I think this might have been intended for you.
As soon as you know more, please let the HR team leaders know.	Thanks for getting on top of this. Please get the word out to the HR team leaders as soon as you know more.
It's a calendar as fyi.	calendar as fyi
See the resume that has been attached.	see resume attached
Looks okay to me, please keep it on file, it looks fine to me.	Looks fine to me. Maureen - please keep on file
I'm not sure what you're talking about.	fyi
Stan wants me to go to the meeting, but I'm not sure when it's going to be.	Could you coordinate with Cindy Stark on the meeting with Massey in a couple of weeks? Stan has asked me if I would like to attend. I would, but don't know when exactly it is scheduled for.
Let's add Rick, Jim and Elizabeth Linnell.	Let's add Rick, Jim and me Elizabeth Linnell 11/02/2000 05:05 PM
The US press on the office opening has been very positive. If you haven't watched it yet, please get in touch with Ann.	congratulations on a great launch! The US press on the office opening has been great. If you haven't seen it, get in touch with Ann Schmidt. Nicholas O'Day 11/02/2000 04:15 AM
Is the publication of the Stanley investigation having an adverse effect?	Great work. Any indication that the publication of the Stanley investigation is having any adverse effect?
Discussed as a topic.	as discussed
Jean doesn't think she has enough money in her budget to pay for all of the work that she's going to do.	Jean has responded to Rick and I. She doesn't feel that she has room in her budget to pick up a partial headcount.
Hartsoe ordered the commission of 75 O888 compl programs.	Hartsoe-Commissions order on 75 O888 compl programs Maya WeberGordon Weil Dave Marquart Richard Tabors
A memo will be out soon.	A memo is coming out shortly.
I'd like to speak to Ken about my background. I am going to see him at the Exec comm today.	Background information. I'd like to talk to Ken about making the call. . . I'll see him at Exec comm today.
The calendar is called fyi.	calendar - fyi
What do you have an interest in?	any interest?
The phone number is at the bottom of the string.	At the bottom of the string is Stacy's phone number
202-287-1321	202-287-1321
Cindy, I think we should use an HR distribution to get this out.	Cindy -- it seems to me we should use an HR distribution to get this out. Let Mike and I know what you think.
You are invited to join them for lunch.	You are invited to join them for lunch. 1:00 - 2:00
I don't think that's right.	fyi
There is a calendar.	calendar
It's not so much a thing as it is a matter of life and deaths. it's not so much a thing as it is a matter of life and deaths.	fyi
I think that you said thank you. Jane.m.tholt@enron.com was the one that said thank you.	Thank you...I think jane.m.tholt@enron.com on 06/15/2001 11:36:01 AM
Is that how I'm taking care of you?	Am I taking care of you or what??
I'm not sure how it's possible for it to be fyi.	fyi
I'm not sure what to make of it.	fyi
There is a calendar.	calendar
It would be better for one of you to speak anyways, since Ken and Jeff aren't available.	Neither Ken nor Jeff are available. It would probably be better for one of you to speak anyway. Any interest?
Minor edits as shown. Otherwise, it looks good.	Minor edits as shown. Otherwise, looks good. Jeff Dasovich Sent by: Jeff Dasovich 01/02/2001 04:20 PM
The file is meeitng.	meeitng file
Looks like you're off to a great start. I would like to see times and locations on my calendar.	Looks like a full slate; you're off to a great start. Maureen -- please put times and locations on my calendar as an fyi. Sarah Palmer@ECT 01/05/2000 02:24 PM
The calendar has to be responded to.	calendar and respond
I just checked with Jeff and Ken, they are away that day. Sorry, it didn't work out, they are both out of the office that day.	I just checked with Jeff and Ken. They are both out of the office that day. Sorry it didn't work out. gilbert whitaker <grwhit@rice.edu> 03/06/2001 07:14 PM
I got a reply from Jeff, who said he was fine with me taking him on the Japan trip.	I got a voicemail response from Jeff - he is fine with me substituting for him on the Japan trip.
Let's take the chance. Cynthia Sandherr is an associate professor of anthropology at the University of North Carolina at Chapel Hill.	Let's take the opportunity. Cynthia Sandherr@ENRON 07/19/2000 06:32 PM
I would like to know if the need to connect new generation quickly is a point.	Looks good. How about a point about the need to connect new generation=20 quickly. =09Sarah Novosel =0909/26/2000 09:55 PM =09=09=20 =09=09
We didn't get to speak before you left, but I can still give you a call when you get a chance.	Thanks for the note and congratulations. Sorry we didn't get a chance to talk before you left. But, I'm still here; give me a call when you get a chance - 1586.
The meeting file is for the meeting.	for meeting file
If we want to do it, the person we would like to interview should be from EEL.	If we are interested in doing this, the interviewee should probably be from EEL
I'll be in London at 12:01PM on October 11th.	I'd love to but I'll be in London Marge Nadasky@ECT 10/11/2000 12:01 PM
The general staff meeting is held in the middle of the day.	General Staff Meeting
Thanks for your work, Rob, your insights on project Stanley are also appreciated.	ditto -- nice work Rob. Your insights on project stanley are also much appreciated.
RSVP for melissa and I at the Lay's party on the calendar.	calendar ... also please RSVP for melissa and I to the Lay's party.
Please check my calendar, it's been awhile since I've done it.	Maureen please check my calendar
I can't say that I think that's a good thing.	fyi
There is a per phone call rate per voicemail.	per voicemail
I'm not sure if we can get someone in IT to respond.	I don't know. Can we get someone in IT to respond? Mary Clark 09/26/2000 05:42 PM
Portland General heard that a press release was going to be released that the state of Oregon should buy PGE.	Portland General called. They have heard that Defazio is going to propose in a press release that the state of Oregon should buy PGE.
You may have seen this before, but it's worth a second look.	You may have seen this when it first came out a while back ... but it's worth a rerun.
Hartsoe, Hogan, SPP, WSCC, Hebert,democratic nominee, and Andy Rotherham are all members of the AAE.	Hartsoe: PJM, Hogan,SPP, WSCC,Hebert,democratic nominee, ACA Andy Rotherham AAE membership (703)875-0764 Gordon Weil page Maureen
Scott Govenar asked if he could send a copy of his check to him at the Hyatt in Sac.	I'm going to be at the Hyatt in Sac. tonight. Could you send a hardcopy to me there? Scott Govenar <sgovenar@govadv.com> 02/26/2001 06:09 PM
Is Catherine working on environmental policy related to sustainable living or is she doing greenhouse gas transactions?	Is Catherine working on environmental policy related to sustainability or is she working on greenhouse gas transactions . . . or both?
Karen Denne posted her revisions and one question on her website.	See my revisions (and one question). Let's revise and circulate. Karen Denne 06/06/2001 05:57 PM
Thank you for the message, Rita Hartfield.	Thanks for the message. Rita Hartfield@ENRON COMMUNICATIONS 07/17/2000 02:52 PM
There is a calendar.	calendar
Call me, I need you to call me.	Please call me.
Rob is going to give an upcoming speech.	mo - calendar Rob - fyi, upcoming speech
The price cap events are of the week.	Fyi - price cap events of the week.
I'm just waiting to hear back from Ken, who had a meeting with him the day before.	Ken was meeting with him the day before yesterday. I'm just waiting to hear back. Sherri Sera 03/13/2001 10:07 PM
Looks ok, by the way, I saw you at the EES on 08/25/2000.	Looks ok Peggy Mahoney@EES 08/25/2000 01:24 PM
Jeff Dasovich sent me a message saying, "Thanks, what's a BEEP?"	Thanks..... what's a BEEP? Jeff Dasovich Sent by: Jeff Dasovich 10/02/2000 05:53 PM
There is tenure at the vp or MD level and not with the organization.	It is tenure at the level (eg vp or MD) not with organization. The color scheme looks good. Gina Corteselli 12/07/2000 08:03 AM
Do not circulate; that's the way it should be.	do not circulate; fyi
My edits are attached.	Attached are my edits.
Please put it in a printed form.	please print
This can be added to our daily distribution.	Let's add this to our daily distribution.
Cindy Olson was born on 08/08/2001.	ok Cindy Olson 05/08/2001 11:48 AM
The schedule and file will be presented by me at the meeting.	schedule and file. I will be presenting at this meeting.
Looks great, Rosie, you might want to put it in Ken's file for the Toronto trip.	looks good. Rosie, you may want to include this in ken's file for the toronto trip Eric Thode 03/16/2001 08:56 AM
If you want him to work, offer him the job.	Offer him the job. Rob Bradley@ENRON 07/25/2000 12:40 PM
Ag dept.	Dept of ag
There was a telegram sent by Jeff Dasovich on March 13, 2001 at 12:10 PM.	yes Jeff Dasovich Sent by: Jeff Dasovich 03/13/2001 12:10 PM
Do you think it's a good idea?	What do you think?
James J. Hoecker was speaking.	Ken Lay speaking, and James J. Hoecker
There is a calendar and a meeting file.	calendar and meeting file
There is a calendar.	calendar
The Largent amendment was amended by the Bliley amendment.	Attached are my comments on the Bliley amendment to the Largent amendment.
There is a calendar.	calendar
There are information from the OPIC.	OPIC information.
Print.	print
I advised against Ken or Jeff going to the generators meeting since Ken is willing to make time for the 3d to meet with the gov.	I have advised against Ken or Jeff attending the generators meeting: Ken is still willing to make time avail on the 3d to meet with the gov.
I called Rob Walls to find out if he would be able to attend.	I am calling Rob Walls to see if he can attend. Carol Ann Brown@ENRON COMMUNICATIONS 03/30/2001 02:49 PM
Montano or Day presentation could be called to the MIT group Texas file.	Call Montano or Day Presentation to ECT presentation to MIT group Texas file, cal file
We are wondering if we will be taking a postion on the purchase of Spanish Hydro utility by TXU.	Are we taking a postion on TXU's purchase of Spanish Hydro utility
There is always some value in these things but they consume more resources in trying to capture the benefit than the benefit itself.	Let's talk. While there is always some value in these things it is ususally quite small and consumes more valuable resources in trying to capture the benefit than the benefit itself.
Looks good to me, Looks good to me, looking good to me, Looks good to me,looks good to me, Looks good to me,looks good to me, looks good to me, looks good to me, looks good to me, looks good to me, looks good to	Looks good to me.
Nick O'Day is in Tokyo.	One more -- Nick O'Day in Tokyo
Can we hear Gary's comments?	can we get Gary's comments?
I'll find out when she can do it, because she loves talking about Houston real estate (one of the many quirks I love her for).	I'm checking. Melissa loves talking about Houston real estate (one of the many quirks I love her for). I'll find out when she can do it. Ricardo Charvel 03/12/2001 01:00 PM
I'm not saying we should buy this service, but I think we need to be on top of the TV spots mentioning Enron to be able to buy this service.	I'm not saying we should buy this service, but I do think we need some way = of=20 staying on top of TV spots mentioning Enron.
Please make sure to check the schedule and get back to the office.	please check schedule and get back to Irwin's office.
The person said you should plan to be there.	You should plan to be there. Michael Terraso 09/22/2000 06:12 PM
I'm not sure what I think of it, but I am a sucker for heart string pulling.	I can hardly believe Peggy Noonan wrote this. I'm a sucker for blatant heart string pulling. I love it. I'm misty.
It's a good idea to fly up and back on the company plane.	Fly up and back on company plane
I can't tell if it was sudden, or if it was just as far as I can tell.	Congratulations on your new position! This all came up rather suddenly, at least as far as I can tell. If you have any interest, I would like to talk to you sometime.
I had major e-mail problems, sorry for the delay. The memo looks good and we need to get it out.	Sorry for the delay (I had major e-mail problems). The memo looks good; let's get it out.
You can speak from 9:00 to 10:00 in the Dogwood Room on the 3rd floor.	You speak from 8:30 - 10:00 - Dogwood Room on the 3rd floor.
It's important to include you on this.	Forgot to include you on this.
Des can set up appointments in Washington DC.	In Washington DC. Get Des to set up appointments
Linda Robertson was the winner on July 19/2001.	Congrats Linda Robertson 07/19/2001 09:44 AM
My proposed changes.	My proposed changes.
That's good news!	Congratulations!
The person is Sue Mara Lance McCarthy.	Sue Mara Lance McCarthy 37141
I sent you yesterday some questions about the bloomeberg story, so if there are any more I'd love to hear from you.	Any follow up questions or India press about the bloomeberg story I sent you yesterday?
I don't know.	fyi
Please handle, if this has been covered by the Office of the Chairman budget, please let me know.	Has this previously been covered by the Office of the Chairman budget? If so, please handle; otherwise let me know.
What kind of interest would you like to have?	Any interest?
The quotes are correct, but I did not state that California does not have a supply problem.	The quotes are accurate, but I did not say California does not have a supply problem. Mark Schroeder@ECT 03/19/2001 06:04 AM
Is there any way to put together a combined presentation on the need for open access and Enron's strategy?	Could you please put together a combined presentation : Enron's strategy and the need for open access on the transmission system?
Joanie wants to eat in NY and has a shuttle that will take her to DC.	Joanie is booking a dinner in NY for this night. 9:00 shuttle to DC
Please call me, I would love to hear from you.	Please call me.
Betsy Diamond in Mike Day's office is making their arrangements, with Mark Haedicke and Sylvia Sauseda.	With Mark Haedicke, keep Sylvia Sauseda and Bernadette apprised of details. Betsy Diamond in Mike Day's office 415-781-0701is making their arrangements
In Skilllings office, a meeting is being held on aviation.	meeting in Skilllings office re aviation
A photographer takes a picture.	6:00 Photographer
The meeting with Ed G. and the Reeds will be in Washington at 7:30 am next Friday.	I set up a meeting for next Friday in Washington with Ed G. and Ralph Reed, starting at 7:30 am.
It looks like you have it now, I believe it's new relevance in light of the announced investigation.	Looks like you got this earlier. I think it has new relevance in light of FERC's announced investigation.
Looks good to me. Dan, I think you are comfortable with it.	Looks fine to me. Dan, I assume you are comfortable with it. Karen Denne 12/06/2000 05:06 PM
Mark's desk could be a good place to stop by and talk to Rob.	Please see attached. Rob, perhaps while in London you could stop by Mark's desk to discuss.
Ken Rice is reachable at 888-666-1846 888-666-1846 888-666-1846 888-666-1846 888-666-1846 888-666-1846 888-666-1846 888-666-1846 888-666-1846 888-666-1846 888-666-1846 888-666-1846 888-666-1846 888-666-1846 888-666-1846 888-666-1846 888-666-1846 888-666-1846 888-666-1846 888-666-1846 888-666-1846 888-666-1846 888-666-1846 888-666-1846 888-666-1846 888-666-1846 888-666-1846 888-666-1846 888-666-1846 888-666-1846 888-666-1846 888-666-1846 888-666-1846 888-666-1846 888-666-1846 888-666-1846 888-666-1846 888-666-1846 888-666-1846 888-666-1846 888-666-1846 888-666-1846 888-666-1846 888-666-1846 888-666-1846 888-666-1846 888-666-1846 888-666-1846 888-666-1846 888-666-1846 888-666-1846 888-666-1846 888-666-1846	OK by me. Ken Rice@ENRON COMMUNICATIONS 05/01/2001 03:48 PM
I am sending this to you, but I don't know what a "DRIP" is.	Okay, so I didn't know what a "DRIP" is, but now that I do, I'm sending this to you.
Mark Palmer said, "Yes, you are."	Yes, you are. Mark Palmer@ENRON 07/17/2000 09:32 AM
I love you, baby. Study hard, study hard, I love you, baby.	I love you, baby. Study hard. Kean_Nora <Nora_Kean@Duchesne.org> on 05/04/2001 01:09:47 PM
Please deal with it.	Please handle
Is this the allocation that reflects the cuts we have already made?	Eliz -- does this allocation reflect the cuts we have already made?
It seems like the Japanese people were kept in the loop.	It looks like Enron Japan was kept in the loop. Let's keep it up. Good luck
There is a calendar.	calendar
You can forward it to the public affairs group.	Please forward to public affairs group.
Print.	print
I'll let you know by me.	OK by me.
claendar	claendar
There is a calendar for this year.	calendar fyi
Tim Brown reported 202-789-7200.	(per Tim Brown 202-789-7200)
Mary Clark x37325 had the word "per" written on it.	Per Mary Clark x37325
Testing is a part of the testing process.	testing
It is possible that Ken will try to reach him while he is on vacation.	Not yet. May not be until sept 5 as ken is on vacation. but there is a chance that ken will try to reach him in the meantime. I'll let you know when I hear.
Thanks for the follow up phone call and invite but I'm not going to see the General.	Thanks for the invite (and the follow up voicemail). I'd love to see the General (and you of course), but I'm going to have to pass. Thanks anyway. Sent by: Cathy Phillips@ECT
Bob Silvanik is the chairman of the CEO panel at the Council of State Governments annual meeting.	Bob Silvanik -- Council of State Governments annual meeting in Dec 8 (CEO panel including Skilling and Hydro Qubecs Kayee? Panel runs 10:45 - 12:15. (606)244-8250
I don't know if this went through or not, I couldn't find the file in my "sent file".	Rosie -- I'm not sure if this went through ... I couldn't find it in my "sent file". Karen -- attached are the documents I mentioned to you a minute ago.
Typo in the second paragraph should not be a company.	Typo in second paragraph .. should be companies not company Karen Denne@ENRON 01/05/2000 01:52 PM
In case you want to get some points through to these witnesses, see the witness list below.	Thanks, Chris. Rick - see the witness list below, in case you want to try to get some points through to these witnesses. Chris Long 09/25/2000 04:14 PM
Soon, the other memo will be published by the other person.	The other memo will follow shortly from Maureen.
There is no problem for Suzanne_Nimocks@mckinsey.com.	No problem <Suzanne_Nimocks@mckinsey.com> 12/07/2000 02:18 PM
The attachment is Karen Myer.	here is the attachment Karen Myer 12/04/2000 05:16 PM
Let me know if I need to be connected via phone, or if you will let me know after the event.	I won't be able to attend. Let me know if I need to be hooked up by phone or if you will just brief me afterward. Paul Kaufman@ECT 12/28/99 04:42 PM
Christi L Nicolay, anything you want me to do?	Anything you want me to do? Christi L Nicolay@ECT 11/28/2000 09:23 AM
The letter looks fine and you can set it up as "your letter to Ken Lay was forwarded to me for response" and have Jeff B sign.	The letter looks fine. Set it up as "your letter to Ken Lay was forwarded to me for response" and have Jeff B sign. Thanks Marcia A Linton 09/20/2000 04:04 PM
I wouldn't take it, but it's hard to see a near term benefit.	Interesting idea, but hard to see any near term benefit. I would decline. Amy Lee@ENRON 08/02/2000 09:30 PM
MIT would like to talk to us about energy procurement and management, but could you please put someone in touch with them?	See last point: MIT would like to talk to us about energy procurement and management. Could you put someone in touch with them?
As was discussed.	As discussed.
I will meet her when I get back.	See if she wants to meet with me when I get back.
You can send comments directly to the woman.	Please send any comments directly to Peggy.
I think it would be a good idea for us to get together and discuss what is going on in the world.	I think it would be a good idea to get together. I would include Eric Thode as he has been living through the PR battles on a daily basis. James D Steffes 05/30/2001 08:31 PM
The calendar is for the beginning, middle, and end of the year.	calendar
If you want to pursue this, please get in touch with Christie.	If you think this is worth pursuing, get in touch with Christie.
Stephen D Burns said he'd be happy to go to DC if there was an alternate.	I won't be going. Let's look for an alternate. I'd be happy to come to DC. Stephen D Burns@ENRON 07/31/2000 10:53 AM
If you get a chance tomorrow, I need to speak to you about Wasaff's project.	I need to talk to you about Wasaff's project when you get a chance .... tomorrow, if possible,b ut not absolutely necessary. Hope all is well.
Please send the piece about the economist to us.	Please send the economist piece around.
Please stop on my calendar.	please block off on my calendar
Steven J Kean received the message and will be able to handle it.	I got the message and will handle. Tahnks Steven J Kean 03/01/2000 11:37 AM Sent by: Maureen McVicker
I made a few changes to the background doc.	I tinkered a bit more with the background doc.
Attached is a picture of the attached letter.	See attached
I don't know if it's a sign or a sign-off. I don't know if it's a sign or a sign-off.	fyi
Never mind... I found them.	Never mind ... I found 'em.
I'd like to get 30 minutes with Mark to make up for lost time.	I'd like to get about 30 minutes with Mark, just to catch up. Mark Schroeder@ECT 07/27/2000 07:47 AM
I'd like to hear from you too, particularly in light of the message you got from Lawson and Jefferson.	I would like your insights. Meredith, I'd like yours as well (particularly in light of the messageyou received from Lawson and Jefferson). Laura Schwartz@ENRON 08/02/2000 08:22 AM
For Ken's next discussion with Cheney, we have recommendations on possible FERC Commissioners.	Our recommendations on possible FERC Commissioners for Ken's next discussion with Cheney.
This is wonderful.	this is fantastic!!
More information.	More info.
I've RSVP'd for you.	I've RSVP'd for you.
The test is to find out if there is any validity to the notion that there is a test.	test
You could forward this to your customers.	You may want to forward this to your customers.
I won't be in town that day, so please keep an eye out for future meetings, I won't be in town that day.	I will be out of town that day (a meeting I can't move). Please continue to let me know about future meetings. Lora Sullivan@ENRON 12/16/99 03:25 PM
Can one of you give Ed a call, or someone that you think is appropriate?	Can one of you forward to Ed, or whoever you feel appropriate?
Please email comments to Elizabeth as soon as possible.	Please send comments to Elizabeth ASAP.
Is it bigger than the tax cut on an annual average basis?	So is it bigger than his tax cut on an annual average basis?
Joe Hartsoe is going to have to deal with it.	Joe Hartsoe to handle.
If you think it's useful, forward on.	Forward on if you find it helpful
It's an attachment.	attachment
I'll send you a tape of my singing voice when I get out there.	Thanks, Nick. I am anxious to get out there soon. In the meantime I'll send a tape of my singing voice. Nicholas O'Day 10/26/2000 06:04 PM
Please send your regrets, so we can make things better in the future.	Please send regrets
Cinergy Audience will be between 400 and 500 people, you will be on a panel with reps from Centerior and Ohio Edison at the LTV Steel's Northern Ohio Energy Conference.	LTV Steel's Northern Ohio Energy Conference, in Cleveland Ohio You will be on a panel with reps from Centerior, Ohio Edison, Cinergy Audience will be between 400-500 ppl Per Terrie James
The meet with the person is at 10:45.	10:45 meet with Cliff Baxter
Please call and let me know when you're leaving so that I can give you my contact information for your new job.	Please call before you leave and please send me your contact information when you have it for your new job. thanks Jane Wilson@ENRON_DEVELOPMENT 05/30/2001 07:31 AM
Do you know if someone at FERC, Hebert or Madden would be available, or if you could suggest an alternative?	Joe -- could you see if someone at FERC -- Hebert or Madden, might be available -- or suggest a suitable alternative?
If you have a high tech group message, see if there is any use in here.	See if there is anythiing of use in here for your high tech group messages.
I would not approve of the company, Enron Capital & Trade Resources Corp.	I would decline Enron Capital & Trade Resources Corp.
It's a little bit of a mystery.	fyi
Who should follow up with Jim andShelley?	Shelley and Jim, who should follow up?
Set up a meeting with Dan Richard, Rick andmaureen, as a response to Tarpey's response on Schnitzer/Tierney.	Response to Tarpey on Schnitzer/Tierney (303)575-6491 Thorn--Linda Breathitt Mont Hoyt Set up meeting with Dan Richard, Rick and maureen
Call me if you're in love with me.	I love you. Call me.
I might add someone to the agenda that is recommended by Ken Lay and Pug Winokar.	I may be adding someone to the agenda -- Vikram Pandit (recommended by Ken Lay and Pug Winokar)
I don't know what's going on.	fyi
Richard Shapiro was fined Fine on July 21st, 2000 10:43 AM.	Fine Richard Shapiro 07/21/2000 10:43 AM
I am not sure what to make of it.	fyi
In the RTO section, I would add "access to" between the words "planning" and "maintenance".	In the underscored language added to the RTO section I would insert "access to" between the words "planning" and "maintenance". Cynthia Sandherr@ENRON 07/20/2000 06:22 AM
The file has a calendar and a meeting file.	calendar and meeting file
The Ritz-Carlton Hotel has a reception at 6 pm and dinner at 7:30 pm for Americans for a Republican Majority.	"Americans for a Republican Majority" Ritz-Carlton Hotel, 1919 Briar Oaks Lane Reception 6:00 - 7:30 Dinner 7:30 - 9:30
You should be proud of me, I am so proud of you.	I am sooooooooooooo proud of you. More importantly, you should be proud of you. Kean_Margaret <Margaret_Kean@Duchesne.org> 02/12/2001 10:00 AM
I will not be able to attend the reception due toincidentally with another Rice group from the engineering school.	I have a reception that evening (coincidentally with another Rice group -- from the engineering school), so I will not be able to attend. Jaime Gualy@ENRON COMMUNICATIONS 11/27/2000 05:48 PM
I'm going to San Francisco on August 14 and will return from there on Wednesday.	Baby, I'm going to San Francisco on Aug 14?(Sunday) returning Wednesday. Wanna go??
How important is this fight to us right now?	How important is this fight to us now (see attached article on ExIm)?
Let's make sure he gets our list of FERC Commissioner candidates, with special emphasis on Wood and Brownell.	Let's make sure that he gets our list of FERC Commissioner candidates (with special emphasis on Wood and Brownell). Richard Shapiro 01/02/2001 02:19 PM
Baum is too late to speak up, and I want to know what SDG&E's energy rate was pre-dereg.	Look at this. Baum finally speaks up -- way too late. Can somebody tell me what SDG&E's energy rate was pre-dereg?
We will attempt to get a copy of gary's comments.	we'll try to get a copy of gary's comments
There is a calendar and a meeting file.	calendar and meeting file
You could try Scott, Mike, or Rick Buy, according to Linda Robertson.	You might try Scott Tholan, Mike Hicks, or Rick Buy. Linda Robertson 11/13/2000 05:36 PM
I don't know.	fyi
Is there a way to survey employees?	do we have a mechanism to survey employees? Can we do a "scientific" poll?
It is small and consumes more valuable resources to try to get the benefit than it is worth.	Let's talk. While there is always some value in these things it is ususally quite small and consumes more valuable resources in trying to capture the benefit than the benefit itself.
Let's communicate Breathitt's interest to Bone and stay out of it for the time being.	Probably not. Let's communicate Breathitt's interest to Bone and stay out of it for now. Richard Shapiro 08/16/2000 08:42 AM
My phone number is per my message.	per my voicemail
Has we been reponded?	have we reponded?
Are you aware of this?	Are you aware of this?
I'll ask him next time I talk to him, because Ken hasn't mentioned it.	Ken hasn't mentioned it. I'll ask next time I talk to him. Linda Robertson 07/03/2001 01:58 PM
It's not something I like to think about, but I think it's something.	fyi
That's correct.	FYI
Let's bring him to Christi L.Nicolay at ECT.	let's bring him in Christi L Nicolay@ECT 10/02/2000 12:29 PM
I'm so sorry to hear about it, but I'm glad the outlook is good and I'll let you know if there is anything I can do to help.	Rick -- I'm so sorry to hear about this, but I'm glad the outlook is good. Let me know if there is anything I can do to help.
Send the attached word document to Jeff as soon as possible.	Fax the attached word document to Jeff ASAP, thanks.
Do you think it's a good idea?	what do you think?
There is a calendar.	calendar
What do you think he's going to add?	What do you think he'll add? Jeff Dasovich Sent by: Jeff Dasovich 10/13/2000 11:01 AM
Please mail melissa kean, 3631 meadowlake, houston, tx 77027) if you would like to do so.	please mail to melissa kean, 3631 meadowlake, houston, tx 77027, thanks "Urban Retreat" <urbanr@neosoft.com> 02/15/2001 09:50 AM
This would have presented a bigger problem than price caps.	See below. This would have presented a bigger problem than price caps.
The message is here, by the way, and it is by the way, and it is by the way, and it is by the way, and it is by the way, and it is by the way, and it is by the way, and it is by the way,	Here it is. Peggy Mahoney@EES 09/12/2000 11:19 AM
The update call used to be daily, now it's weekly, but you can add it to the distribution list.	There is also a california update call (used to be daily, now weekly). Marcia Linton (Jim Steffes' assistant) can give you the call in information and add you to the distribution list.
Thanks for the update, nice to see you are moving in the right direction.	Thanks for the update. Congratulations on your progress. Keith Miceli@ENRON 07/24/2000 04:18 PM
I don't know what to make of it.	fyi
Please reserve 47c1 for the meeting so I can use the computer screen, Karen needs to send these to me for today's 1:30 meeting.	Ask Karen for the distribution list she would like to send these to for today's 1:30 meeting. Also please reserve 47c1 for the meeting so I can use the computer screen.
The budget meeting of EES.	EES Budget meeting ?
