If you're interested in attending either class, please let me know by Friday.	Just a reminder - if you are interested in attending either class, please let me know by Friday. Thanks! Amy
Done!	Done!
I'm checking on the status of Brian Terp, and I'm not sure if we owe him any revisions or if he has returned his letter.	Kevin - Just checking on the status of Brian Terp - we are showing that he is still open. Has he returned his letter or do we owe you any revisions? Thanks! Amy
Amy, can you please send your name to me by Wednesday?	Just a reminder - can you please send your names to me by Wednesday? Thanks! Amy
I'm not sure if it has a name change on it.	Does it have the name change on it? I could always give it a try.....
Please don't contact me with any questions; I'll see you in the morning.	If you have any questions, please contact me at 713-859-6266. See you in the morning! Amy
I've passed it on to Dave and I'll let you know.	I have passed it on to Dave and will let you know! Amy
Is Heather staying with Risk or is she taking Kit Blair off the list?	Stacey - So is Heather staying with Risk or is she going to Volume Management (taking Kit Blair off the list). Thanks! Amy
I send this to myself, it's what an idiot I am.	What an idiot I am - I sent this to myself! Amy
Kevin, I have Jeff's revised contract, but I need to see you on Tuesday.	Kevin - I have Jeff's revised contract. Please see me on Tuesday. Amy
Thank you so much for giving me a call this evening, Amy!	Here you go -thanks so much for giving me a call back this evening! Amy
An information session will be held today at 11:30 AM in Mt Hood.	REMINDER - INFO SESSION TODAY AT 11:30 AM in MT HOOD.
If you did not hear back from her, she can be found at 713-875-5617.	on your question from yesterday. If you didn't hear from her, her direct number is 713-853-5617. Have a great day! Amy
I hope you're doing well.	Thanks Bert. I hope that you are doing well.. Amy
Your details have been forwarded by me and I'll let you know when it's done.	I have just forwarded your details to be updated. Will let you know once it has been completed! A
Amy, do you know where the location is?	Great Craig - thanks....do you happen to know the location? Amy
Let me know if I can help you, as I agree with you that the number that I gave you is not very helpful. Diane is the payroll manager.	Diane is the payroll manager - I called the number I gave you and agree that it is not very helpful.... Her extension is x35617. Let me know if I can do anything else for you! Amy
We don't have them here, so I'll call Stamford and see what I can do.	We don't have them here, but I will call Stamford and see what I can do. Thanks! Amy
Please leave with either me or Grace because I haven't received your check for $25.00.	Just a reminder - I still have not received your check for $25.00. Please make your check payable to Enron Corp and leave with either me or Grace. Thanks! Amy
Tim Heizenrader will be in Mt Hood today to hold an information session.	Just a Reminder..... Tim Heizenrader will be holding an information session today (Wednesday) at 11:00 am in Mt Hood.
We are going to communicate with individuals who have been identified to go to NETCO, so please let me know if you have any questions.	Attached are the talking points that we will be communicating to individuals who have been identified to go to NETCO. If you have any questions, please let me know. Amy
Please do not hesitate to ask if there are any questions, as this is just a reminder that all feedback must be completed by Friday, November 17th.	This is just a reminder that all 360 feedback must be completed by Friday, November 17th. If you have any questions, please do not hesitate to ask. Thanks! Amy
Amy Salisbury gave a huge thumbs-up on April 24, 2001.	Thanks! Amy Holden Salisbury 04/24/2001 09:50 AM
Amy "Kate Symes" thanked me for letting her know.	Great Kate - thanks for letting me know! Amy "Kate Symes" <katesymes@microsoft.com> on 04/23/2001 01:01:10 AM
Here are the numbers for each location, written by Louise and Amy.	Louise - Here are the numbers by location. Amy
Please let me know if you'd like to take this course by the close of business today.	Just a reminder - If you are interested in taking this course, please let me know by close of business today. Thanks! Amy
Thanks, Amy!	Thanks Holden! Amy
The checks that she gave you with the check number were the receipts that she had for them. She contacted accounting and was able to confirm which checks had been cashed.	Tammie has the receipts from the checks that she gave to you with the check number....she contacted accounting and was able to confirm which checks had been cashed.
Bill, here is the information that you requested.	Bill - Here is the info that you requested. Geir $49,000 - no change Ryan $52,500 Mark $50,000 Bert $46,000 Leaf $50,000 No other changes! A
Please let me know if you have any questions, Sally and Bob, here is the employee listing for Netco.	Sally and Bob - Here is the employee listing for Netco. Please let me know if you have any questions. Amy
Just a quick note to let everyone know that there are some information sessions for today.	JUST A REMINDER ABOUT THE BELOW INFO SESSIONS FOR TODAY!!!!!
Kevin, did you talk to John about any other follow-ups?	Kevin - Did you talk with John about these - is there any other follow-up that I need to do? Thanks! Amy
I have talked to Tim and I'm waiting to see if we've made any progress.	I have talked to Tim and he was going to get back with me. I will see if we have made any progress. Thanks! Amy
Done!	Done! A
Please let me know if you have any questions about where your chair is located, it is located in either Mt Hood or Mt Adams.	Just a reminder - your leather chair that you have purchased from Enron is located in either Mt Hood or Mt Adams. If you have any questions, please let me know! Amy
Amy, here you go!	Here you go! Amy
Thanks for all of the assistance with the Portland contracts, Louise! Have a great day!	Thanks Louise for all of your help with the Portland contracts. I know they weren't easy and I really appreciate the support. Have a great day! Amy
I'll put your name in the hat, thank you Bill!	Thanks Bill - I will put your name in the hat (so to speak)! Amy
Amy, do I need to send a letter to him, because we don't have a position available for him?	Holden - Unfortunately, we don't have a position available for Thaddeus. Do I need to send him a letter? Thanks! Amy
Bill, Ryan and Geir were the only two individuals that expressed interest. How do you want to run the process from here?	Bill - The only 2 individuals who expressed interest are Ryan and Geir. How would you like to run the process from here..... Thanks! Amy
Your password is YYYYMMDD and you have your personnel number p00562623, which you can find on 888-353-1299 888-353-1299 888-353-1299 888-353-1299 888-353-1299 888-353-1299 888-353-1299 888-353-1299 888-353-1299 888-353-1299 888-353-1299 888-353-1299 888-353-1299 888-353-1299 888-353-1299 888-353-1299 888-353-1299 888-353-1299 888-353-1299 888-353-1299 888-353-1299 to 888-353-1299 888-353-1299 888-353-1299 888-353-1299 888-353-1299 888-353-1299 888-353-1299 888-353-1299 888-353-1299 888-353-1299 888-353-1299 888-353-1299 888-353-1299	Your personnel number is p00562623 and your password is YYYYMMDD for your birth date. Amy Kate Symes 10/13/2000 11:32 AM
I need to swap out pages when you get a chance, but I received the correct version of Jeff's contract.	I have received the correct version of Jeff's contract. See me when you have a minute so that I can swap out pages. Thanks! Amy
The black leather chairs that were available have all been sold.	Thank you all for your interest and participation!! All the available black leather chairs have been sold! Amy
Please see me when you have a moment, I have offers for Carrie and Michael.	Don - I have offers for Carrie and Michael - please see me when you have a minute. Thanks! Amy
Please note that there are additional details for tomorrow's meeting.	FYI - Please see additional details for tomorrow's meeting. Thanks! Amy
Please contact me if you're interested in an administrative position in HR, I'll let you know by the close of business Wednesday.	If anyone is interested in an administrative position in HR, please see me by close of business Wednesday for more details. Thanks! Amy
Please join Elliot for a brown bag lunch on June 22 in Mt Hood to learn more about the renewable energy and Enron's work in this area.	Please join Elliot for a brown bag lunch on Friday, June 22 at 11:30 am in Mt Hood to learn more about renewable energy and Enron's efforts in this area.
Amy, have you spoken to Jeff?	Bill - Have you and Jeff talked? Thanks! Amy
I have ordered Karen to check to make sure they didn't get it yesterday.	Scott - It went to UBS on Friday overnight delivery. I have asked Karen to check to make sure they did not receive it yesterday. Amy
I don't know if you have direct deposit or a check, I didn't see your name on the list.	I didn't see your name on the list - do you have direct deposit or was it a check? Kate Symes 01/03/2001 11:10 AM
