Rosie, I wanted to know if you would be interested in Jonathan Lash's report.	Thought you would be interested in Jonathan Lash's report. Rosie
Attached is the draft Dynegy release.	Mr. Watson - Attached is the draft Dynegy release. Thanks. Rosie for Ken Lay
Elizabeth Lay lizard_ar@yahoo.com> was the one who said it was done.	It's done!! Elizabeth Lay <lizard_ar@yahoo.com> on 02/02/2000 02:00:25 PM
Unfortunately, Mr. Lay will be out of town that day. Rosie "Annie R. Jones"	Hi Annie - Unfortunately, Mr. Lay will be out of town that day. Rosie "Annie R. Jones" <AJones@uwtgc.org> on 04/14/2000 04:56:07 PM
On March 13th 2001 at 03:53:29 AM news@newsworld.co.uk	news <news@newsworld.co.uk> on 03/13/2001 03:53:29 AM
Thank you, Maryse, this is very helpful.	Thanks, Maryse. This is very helpful. Maryse_Zwick@weforum.org on 05/17/2000 12:45:16 PM
Mark will send it right away.	Will send right away! Mark Schroeder@ECT 01/26/2001 07:07 AM
I wanted to let you know that Ken Lay will be there, or he wouldn't have been there.	Ken Lay will be there. I thank you for your e-mail or he wouldn't have been there. Rosie CEO Extra <CEOextra@houston.org> on 07/10/2000 09:30:16 AM
The word document appears to be blank.	Jeff, the word document appears to be blank. Rosie
That's correct.	FYI
Good morning, Rosie, what time is the meeting?	Good morning, Mike. What time is the meeting? Rosie
I don't think Ken will be calling in, but I'll let you know.	Katherine, Ken will be on vacation, so I don't think he'll be calling in. However, I'll let you know. Rosie Katherine Brown 08/15/2000 11:24 AM
I would like to refresh my memory on what the report is.	Mr. Sikes, please refresh my memory what the TF report is. Rosalee JSikes@cfr.org on 03/21/2001 08:19:54 AM
Ken Richard Amabile would be happy to do this.	Dick, I would be happy to do this. Ken Richard Amabile 02/14/2000 12:00 PM
It's perfect now, that's right.	It's perfect now.
On March 22, 2001 10:38:11 AM, Richard Nolan : RichardNolan@smipublishing.co.uk	Richard Nolan <RichardNolan@smipublishing.co.uk> on 03/22/2001 10:18:12 AM
Gary, I could open it with no problem.	Gary, I could open it perfectly!!
Ken Lay will not be in town. "Sharon Kimmel", "skimmel@iexalt.net", or something similar, said, "hi Sharon - Ken Lay will be out of town."	Hi Sharon - Ken Lay will be out of town. Thanks. "Sharon Kimmel" <skimmel@iexalt.net> on 06/27/2000 10:24:54 AM
Theodore.a.schwab@rssmb.com was referred to by the name "Schwab, Theodore A" on March 23, 2001.	"Schwab, Theodore A [PVTC]" <theodore.a.schwab@rssmb.com> on 03/23/2001 01:47:49 PM
Please let me know if you will be able to attend in person or on a conference call, as there will be a Management Committee meeting in the Boardroom on Monday, January 14, 2002 at 11:00 a.m.	There will be an Enron Management Committee meeting in the boardroom on Monday, January 14, 2002 at 11:00 a.m. Please let me know whether you plan to attend in person or via conference call. Thanks. Rosie
Mr. Lay won't be able to meet with Mr. Thompson.	Mr. Lay will not be available to meet with Mr. Thompson. Rosalee "Sheila Whitman" <sheila@ctaonline.com> on 04/18/2001 04:13:08 PM
Rosie, your dad just asked if you had sent an email where you are staying in Miami.	Hi Mrs. Vittor - Your Dad just asked if you had sent an e-mail where you are staying in Miami. Rosie
Ken Lay will not be able to attend the Annual Board Meeting of the Asia Society in October 2000 because he has conflicts on the calendar.	Unfortunately, Ken Lay will not be able to attend the meeting of the Asia Society Annual Board Meeting in October 2000. He has conflicts on the calendar. Thanks. Rosalee for Ken Lay
Ken will be in attendance at both of the meetings.	Ken will attend both meetings. Rosie Sherri Reinartz 01/12/2000 03:30 PM
Anna orKristi will then pass on the report to whoever they deal with in Maintenance.	Gary, every time Ken tells me to report it, I tell Anna or Kristi and they, in turn, pass it on to whoever they deal with in Maintenance. It has been at least 3 times. Rosie
Please let me know if the timing doesn't work because he will be in town.	Terrie, nevermind. He will be in town. Let me check with him, so the timing may not work. Thanks. TERRIE JAMES@ENRON COMMUNICATIONS 04/16/2001 10:26 AM
Tim, just wanted to let you know that Mr. Lay has already made a donation to Sandy Hoelscher for the Beach Bowl.	Hi Tim - Just to let you know that Mr. Lay has already pledged to Sandy Hoelscher for the MDA Beach Bowl. Thanks. Rosalee Timmy Ng@ECT 07/06/2000 09:52 AM
Rosie "Garten, Jeffrey" said Ken Lay wouldn't be able to attend.	Unfortunately, Ken Lay will not be able to attend. Rosie "Garten, Jeffrey" <jeffrey.garten@yale.edu> on 03/16/2001 01:31:52 PM
If you're on-line, please reply. I have questions, but I'll ask them.	Dar, are you on-line? If so, please answer back. I have questions. Well, I'll ask them. Did you get the wedding pics? me
Please tell me the time of the meeting. I can't remember. Ken is back at the office at 1:00 p.m.	Please confirm the time of the meeting. Sorry, but I can't remember. Ken has a 1:00 p.m. back at the office.
I will forward this to you for further handling. Ken is on vacation, but I will send this to him.	Jeff, am forwarding this to you for your info and possible further handling. Ken is on vacation, but I will send this to him. Thanks. Rosie
Amen to Jerry's words!	Amen to Jerry's comments!
Michael, I think Monday will be fine.	Michael, I think Monday will be fine. Enron Energy Services
This came through perfectly, the address looks perfect.	Michelle, this came through just fine. His address looks perfect. Rosalee Michelle Michot Foss <mmfoss@UH.EDU> on 08/15/2000 07:13:38 PM
On March 23, 2001, "Derek Telander" was contacted by ctaonline.com.	"Derek Telander" <Derek@ctaonline.com> on 03/23/2001 02:26:14 PM
Please remove it. "Katz, Mayor" mayorkatz@ci.portland.or.us> on 11/09/2000 08:29:39 PM	Please remove from distribution. "Katz, Mayor" <mayorkatz@ci.portland.or.us> on 11/09/2000 08:29:39 PM
Ken won't be at the meeting.	Ken will not be here for the meeting. Katherine Brown 09/26/2000 11:59 AM
Ken Lay won't be able to attend.	Ken Lay will not be able to attend. Rosalee Paulette.Brunson@bakerbotts.com on 03/12/2001 10:41:33 AM
If you can't make it, you can respond to dmitry@worldrg.com.	Kenneth Lay will not be able to attend. <wci_mail@www.worldcongress.com> on 03/23/2001 02:05:11 AM Please respond to dmitry@worldrg.com
Ken said that he supports you extending the offer.	John, Ken said that he does support you extending the offer. Rosie
ia	ia
"Lance, this looks good to me", said Ken Lay.	Ken Lay said "Lance, this looks fine to me". Rosie
Ken Lay said to tell Michael this was fine.	Michael - Ken Lay said to tell you this is fine. Rosalee "Telle, Michael S." <mtelle@velaw.com> on 10/02/2000 10:18:00 AM
I'm not sure if this is the thing you were working on at one point, or if it should go to Sally Beck.	Mark, is this what you were working on at one point? Maybe it should go to Sally Beck, but I'm not sure. Rosie
Thanks, Barbara!	Thanks, Barbara!
Please respond to Janet Mathews, who is at jmathews@jefferson-usa.com.	Yes, indeed. Janet Mathews <jmathews@jefferson-usa.com> on 04/07/2000 10:57:20 AM Please respond to jmathews@jefferson-usa.com
Here it is, have a great day, stay warm.	Here it is!! Have a great day!! Stay warm. Shea_Dugger@i2.com on 12/06/2000 01:38:30 PM
Please let me know if you want to attend the meeting in person or by phone, I'll give you the call-in number.	Please let me know as soon as possible if you can attend this meeting in person or if you want to call-in. I will provide the call-in number. Thanks. Rosie
Ken said he was fine with it.	Ken, Ken Lay said he is fine with this. Rosie Ken Rice@ENRON COMMUNICATIONS 05/01/2001 03:48 PM
Thank you, Anabella, I couldn't figure out why Mr. Lay received it.	Thanks, Anabella, as I couldn't figure out why Mr. Lay received it. Rosalee Anabella De Sousa 03/15/2001 11:36 AM
Not interested service@sbsubscriber.com.	Not interested service@sbsubscriber.com on 01/20/2000 11:08:58 AM
Thank you so much for sending flowers today, they made our day wonderful and you are all the most thoughtful and sweet.	You are all the most thoughtful and sweet!!! Thank you so much for the flowers that you sent today!! You made our day wonderful!! Thanks so much!!! Rosie
Thanks again, Rosie. I'll give to Ken.	Thanks, Jeff. I will give to Ken. Rosie
On April 9, 2001 at 03:43:34 PM, BYOBroadcast's info@byobroadcast.net was updated.	BYOBroadcast <info@byobroadcast.00b.net> on 04/09/2001 03:43:16 PM
That's right.	FYI
David contacted us and said that he received this from us.	We did receive this from David. David Haug@ENRON_DEVELOPMENT 12/13/2000 02:14 PM
The e-mail was received by us, but we didn't know it was from Ken Lay "Michael Milken".	Hi - We did receive the e-mail. Rosalee for Ken Lay "Michael Milken" <mmilken@knowledgeu.com> on 07/02/99 10:21:40 AM
On March 13, 2001 at 04:56 PM, "Bill Ennis" bennis@txoga.org> was contacted.	"Bill Ennis" <bennis@txoga.org> on 03/12/2001 04:56:08 PM
The attached expense report has been approved by Kenneth Lay.	Kenneth Lay has approved the attached expense report.
I appreciate it, Lisa. I was told by John to call you and Aleck.	Thanks, Lisa. I appreciate it. John was asking me to call you and Aleck. Rosalee Lisa Assaf@ECT 04/02/2001 10:37 AM
Ken wanted you to have a copy of the book.	Ken wanted you to have a copy
Please let me know when this is completed so that I can arrange for Mark to have the same rights as Suzanne.	Will you please arrange for Mark LaGrange to have immediate rights to the Enron Executive Database. These rights should be identical to Suzanne Neville's rights. Please let me know when this is accomplished. Rosalee
Ken wanted to know if you watched the speech.	Ken wanted to make sure you saw this speech.
Pedro Ralda is the Director of Latin America and will not be able to participate in the conference.	Dr. Lay is unable to participate in the conference. "Pedro Ralda, Director Latin America"<mexicomeeting@weforum.org> on 08/31/2000 02:03:23 PM
I am not sure how the address shows up, but they tell us that it's kenneth.lay@enron.com.	Liz, I don't know how the address shows up when sent, but they tell us it's kenneth.lay@enron.com. Talk to you soon, I hope. Rosie
Joe, I don't know when the big OECD Forum is, but I am pretty sure I'm missing something.	Joe, I am probably really missing something on this, but I can't determine when the big OECD Forum is. Rosie Joe Hillings 02/08/2000 03:27 AM
Good morning, Ken will be here.	Good morning!!! Ken will be here. rosie Katherine Brown 07/14/2000 08:35 AM
Ken Lay asked Rosie Colin Skellett to tell him that this was fine with him.	Hi Colin - Ken Lay asked me to advise you that this is fine with him. Rosie Colin Skellett@AZURIX 10/26/2000 10:20 AM Sent by: Lisa Hobbs@AZURIX
Rosie Janel, I hope to hear from the Governor's office by the end of the day.	Thanks, Janel. I hope to hear from the Governor's office late this afternoon. Rosie Janel Guerrero 04/27/2001 02:39 PM
Rosie Sharon Lay will have him there.	Thanks, Sharon!!! We'll have him there. Rosie Sharon Lay <sharon.lay@travelpark.com> on 04/18/2000 06:18:13 PM
Thanks, Sharon - Ken Lay will be out of town.	Hi Sharon - Unfortunately, Ken Lay will be out of town. Thanks. Rosalee "Sharon Kimmel" <skimmel@iexalt.net> on 05/24/2000 04:18:18 PM
Cindy Olson's expense report is attached and has been approved by Kenneth Lay.	Kenneth Lay has approved Cindy Olson's expense report, which is attached.
Ken Lay will be at the event.	Ken Lay will attend. Billy Dorsey@ENRON_DEVELOPMENT 03/21/2001 09:33 AM
Colin, will you please do it? Ken is in Japan.	Will you please do it, Colin? Ken is in Japan. Rosie Colin Skellett@AZURIX 10/31/2000 10:59 AM Sent by: Lisa Hobbs@AZURIX
I think you would like to see this as well.	Thought you might like to see this also.
Mr. Lay will accept the call from the OPIC and I wish Eva the best of luck.	Hi Eva - Mr. Lay said that he will be happy to do this - accept the call from OPIC. Rosalee Eva_Evgenis@acml.com on 04/26/2001 12:41:14 PM
Sharon, we received it, rosalee "Sharon" "skimmel@iexalt.net" on September 28, 2000.	We received it, Sharon. rosalee "Sharon Kimmel" <skimmel@iexalt.net> on 09/28/2000 11:42:32 AM
It is noted that this is FYI.	FYI
Linda Bernson is a member of the Western Coal Council.	Western Coal Council -- Linda Bernson <lindaeb@westcoal.org> on 04/11/2000 04:37:11 PM
Please inform me if you will attend the meeting via conference call or in person.	There will be a Management Committee meeting on Wednesday, January 2, 2002 @ 11:00 a.m. Please let me know if you will attend in person or via conference call. Thanks. Rosie
The Chairman of the Board is Kenneth L. Lay.	Kenneth L. Lay Chairman of the Board ENRON "Garten, Jeffrey" <jeffrey.garten@yale.edu> on 02/28/2001 01:47:58 PM
I would like to let you know that Ken is going to join the board of i2 Technologies, Inc.	Hi Sherrie and Sally - To let you know that Ken has agreed to join another board. It is i2 Technologies, Inc. The company is based in Dallas. Please let me know if you need further information. Rosie
On March 21st, 2001 at 04:02:46 PM, lists@nbr.org was added to the list.	lists@nbr.org on 03/21/2001 04:02:46 PM
Absolutely!	Absolutely!!
The date is July 25th, 2000	Katherine Brown 07/25/2000 11:51 AM
The globalist@ theglobalist.com was opened by Stephan Richter on March 22, 2001.	The Globalist/Stephan Richter <theglobalist@theglobalist.com> on 03/22/2001 12:11:56 PM
Good morning, Rosie - Ken will be able to do it on Thursday.	Good morning, Shea - Ken Lay will be able to do this Thursday afternoon. Rosie Shea_Dugger@i2.com on 04/09/2001 05:10:20 PM
Sally has the number for the Montriand.	Sally: Here is the number for the Montriand #2680. Tori
I'm sorry but I wasn't aware that the name had been changed.	Sherri, I'm sorry I have been sending your e-mails to the "old" name. I didn't realize it had been changed, but this is so right and very good! Rosie
The name is "ML-Steven. I.Fleishman" and it was published on 11/30/2000.	"ML-Steven.I..Fleishman" <ML_Research@ml.com> on 11/30/2000 07:23:50 AM
Ken and Greg, I'm pretty sure you both have an interest in this proposal, but if you know someone else that should be included, please include them as well.	Ken and Greg - I think you are the two who would most likely have an interest in this proposal, but if you know someone else that should be included, will you please include them also. Thanks. Rosie
The proposal is satisfactory to Ken Lay, that is whatRosalee "Holloway, Wanda" said.	The proposal is totally satisfactory to Ken Lay. Rosalee "Holloway, Wanda" <Wanda.Holloway@COMPAQ.com> on 04/19/2001 01:44:06 PM
The meeting won't be held on Tuesday after the holiday due to the MC mtg.	Given that we are having the MC mtg. on Wed. afternoon, there will not be a meeting on Tuesday, following the holiday. Thanks. If any questions, please give me a call. Rosie - 36088
Ken will not be in the office.	Ken will be out of the office. Sherri Sera 09/21/2000 02:53 PM
Sorry, Simone, I don't think we received it.	Sorry, Simone. I don't believe we received it.
"Rightworks Marketing" rightworksmarketing@rightworks.com> on March 15th, 2001 was the reply.	"Rightworks Marketing" <rightworksmarketing@rightworks.com> on 03/15/2001= =20 03:22:26 PM Please respond to rightworksmarketing@rightworks.com
