Chris and Scott Neal are the people that I am working for.	Yeah, right. I wish! I am working for Chris still and Scott Neal.
You're not any fun at all!	you are no fun at all!
I was thinking about leaving early to go shopping or eat something, because I think we need to be there at 2.	I think we have to be there at 2:00. But I was thinking about leaving early to go shopping or eat or something.
The deal was made.	deal
Do you plan on attending the orientation today at the Houstonian?	Are you going to that lame ass orientation today at the Houstonian?
We're going to do something next week.	What are we going to do next week?
We are going to have to do something about that soon.	we're just going to have to do something about that soon!
Not recently.	not lately
You're still here.	you still here
We're going to be sitting close to each other after the move.	We're going to be sitting kina close after the move.
You're not stupid, that's for sure!	You're not old silly!
I'm always ready.	I'm always ready
I was sure that you would think so.	I figured you would think so
Are you going to be the big cheese now?	REALLY, where is he going? Are you going to be the big cheese now?
You don't know how much I miss it!	you don't know how much I miss it!
It's a nice shirt.	Nice shirt
When I get out of here, I'll meet you in the bar.	I'll meet you in the bar when I get out of here
Sounds good!	Okay...sounds good!
Yes, you?	yes, you?
This meeting has been changed to 10:30 a.m. and it will be held in the same conference room.	This meeting has changed to 10:30 a.m. It will be held in the same conference room. Thanks, Amanda
Don't use your computer if you don't like the noise.	If you don't like the noise, mute your computer.
When you are done getting your hair cut, I would love to hear from you.	Call me when you get done getting your hair cut
Forget Front Porch, you look amazing today, savesay savesay savesay savesay savesay savesay savesay savesay savesay savesay savesay savesay savesay savesay savesay savesay savesay savesay savesay savesay savesay savesay savesay savesay savesay savesay savesay savesay savesay savesay savesay savesay savesay savesay savesay savesay savesay savesay savesay savesay savesay savesay savesay savesay savesay savesay savesay savesay savesay	You look incredible today. Forget Front Porch!
I just received my offer letter, so I'm not even thinking about it at the moment.	Not at all...I just now got my offer letter...FINALLY. What about you? Anything exciting?
I will definitely do that.	I will definitely!!
I'll just get my pager tomorrow and leave, you won't be able to see me until later.	I'll just get my pager tomorrow, I'm leaving. See you later.
We'll see about that, it's slick!	we'll see about that, slick!
It's been a pleasure talking to you.	Well it sure has been nice talking to you.
You're not helpful.	you're no help
Not much, miss me?	not a whole lot! miss me?
I will do the same.	I will too
I'm not sure if I can leave yet.	I don't know if I can leave yet...hang on a sec
We will travel from there.	we will go from there
Sounds like a plan that's in the best interests of me.	Sounds like a good plan to me!
Alright, I will this week!	okay, I will...this week!
You are the biggest cheese to me, baby!	you are the big cheese to me baby!
Do you like it?	you like?
What are you going to do at the doctor's office?	why are you going to the dr?
I need a pager from you.	I need to get my pager from you
Let's go.	okay, let's go
I don't know what you are thinking about.	I don't know, where do you have in mind
I like it, it's good!	Good!! I like it!
Is it today that you are here?	are you here today brat?
I like it.	I know....I like it!!!
Is it necessary for you to have company?	you need company?
I think I would treat you better than she does.	I think so, I would treat you better than she can
Are you leaving today?	When are you leaving today?
I'm sorry, but I've been worried about you, and I'm going to have a drink this week.	I'm sorry, and I know I have probably been bugging you, but Ive been worried about you. Wanna go have a drink this week?
You noticed.WOW!	you noticed!! WOW!
Let me know when you're leaving.	Let me know when you're leaving today
That was my plan, that's what it was!	That was my plan!
I was going to the game and I was really annoyed that I kept falling asleep.	Hell yeah! I was going for the Patriots too! So I was really pissed when I kept falling asleep!
Which door is next to it?	which next door?
We will have to see, I don't know yet.	I don't know yet. We'll just have to see.
I can't believe you came home after bailing! What possessed you to do that?	Wow! I can't believe you bailed and came home!! What possessed you to do that?
What are you talking about?	what?
Yes, baby!	yeah baby!
A new adventure is on it's way!	Ooohhh....a new adventure!!
Yes, I am aware of it.	yes i know!
Oh, ugh.	ugh
Yes, right.	yeah right
Do you know when you're leaving today?	What time are you leaving today?
I'm pretty happy with the deal, but not as happy as I would be if I were working for you.	No, I'm actually pretty happy about the deal. Not as happy as I would be if I were working for you.
I can walk down with you if you're leaving earlier.	I don't know, probably 5. But if you're leaving earlier, I can walk down with you.
Depending on how I'm feeling I might be able to finish by the end of the week.	maybe towards the end of the week...depending on how I'm feeling!
I'm excited!	ooohhh, I'm excited!
I'm sorry, but did you get out of here yesterday?	sorry...when did you get out of here yesterday?
Have a great night.	Okay, have a good night
So am I!	So am I!
I was thinking you were leaving early.	I thought you were leaving early?
I know, but I would be able to if you were my boss.	I know, but if you were my boss, then I would be able to
I don't want to get in trouble for not going and I am pretty pissed off about having to go.	Ok...I am pretty pissed off about having to go, but I don't want to get in trouble for not going.
I'm okay but I'm having a headaches and I think you need to as well.	I think you need to too. I am feeling okay, except for this headache that is creeping up. How are you today? Were you here yesterday?
I think so.	I think so
You're driving me crazy, you're driving me crazy, you're driving me crazy, you're driving me crazy, you're driving me crazy, you're driving me crazy, you're driving me crazy, you're driving me crazy, you'	you're driving me crazy
Brian is out of town, so just let me know if you want to go.	any day you want to go, Brian is out of town, so just let me know
Do you not worry about that?	Don't you worry about that
I think I'm going to have to wear them more often.	Well then I guess I'm going to have to wear them more often.
I would love to have company.	DUH!! I want company.
I know a few things.	I know a few ways!
I'm blonde again, so have you seen me today?	Have you seen me today? I'm blonde again!!!
The meeting will be held in the same room on Tuesday, and it will be at 10:00 am.	Correction...the meeting will take place on Tuesday at 10:00 am. It will be held in the same conference room. Sorry for the inconvenience. Amanda
Yes, you are.	yes you
When?	when?
You can meet me at the elevator.	Yeah, meet me at the elevator!
I'm going to shoot for 3.	I'm going to shoot for 3
