I would suggest that you give the person making the call the attached note, so that he or she has more background on the Ontario market.	Here are the Sithe talking points. I would suggest that you give the person making the call the attached note re Ontario, so he or she has more background on the Ontario market.
Rob Hemstock and I both agree that Project Stanley should be on the list near the top, but we left it off for reasons of confidentiality.	Rob Hemstock and i agree that Project Stanley should be on the list near the top but we left it off the list for reasons of confidentiality.
I think it's a good idea to have the attached.	I thought it would be useful for you to have the attached.
The State Department provides assistance.	FYI. Assistance from the State Department.
There are two articles on this one, the first one is about Enron and the second one is about Lay.	This is the first of the two articles re Enron and Lay.
I will use this on Monday and Tuesday when we see people in Finance and Energy.	Jeff , thanks. I am using this stuff on Monday and Tuesday when we see people in Finance and Energy here. Here is my own contribution to the discussion - something I wrote a few months ago and recently revised.
There's something to be said.	FYI
I think that's correct.	FYI
I think that Mary should join the group to work withRob and Jeff on the Northwest if they want to, in order to make sure that Jeff isn't tagged to do double duty.	Listen, in order that Jeff is not tagged to do double duty ( or half duty), I think I should ask Mary Hain to join the group to work with Rob (and Jeff if he wants) on the Northwest. Agree?
The Progressive Conservative Party has an Advisory Committee on Energy.	FYI- PACE is the Progressive Conservative Party Advisory Committee on Energy.
If you're speaking with Bill, please keep that in mind.	FYI - in case you are speaking with Bill.=20
Paul was in agreement with what I had to say.	FYI - Paul agreed with my suggestions.
That's correct.	FYI
I am not certain if Glenn has already forwarded this to you, but I am aware that Seabron will be speaking at the meeting on July 20.	Attached is a draft of the material to which Seabron Adamson intends to speak at the meeting on Thursday July 20 at Blakes office in Calgary. I am not sure whether Glenn Leslie has already forwarded this to you.
Foster wrote the article after reading Prof Krugman's article in the New York Times.	This was an article written in response to the piece by Prof Krugman in the New York Times several weeks ago. I know that Foster spent some time on the phone with Steve and Mark before writing the article.
The ads run by the socialists have been getting a lot of attention.	FYI - ads run recently by the socialists.
We might want to send Skilling instead of Lay to meet Harris.	Maybe we should send Skilling rather than Lay to meet Harris.
The ads are run by the socialists.	FYI - ads run recently by the socialists.
That's correct.	FYI
I think it would be a good idea for you to have the attached.	I thought it would be useful for you to have the attached.
We would like to get a copy of the study.	Jeff, can we get a copy of the PX study? Thanks
Paul was in agreement with my suggestions.	FYI - Paul agreed with my suggestions.=20
The part of the articles I was interested in was about the importance of forward markets and the lunacy of the restrictions on IOU forward contracting.	I don't have anything but the news articles - the part that I was interested in was the part about the importance of forward markets and the lunacy of the restrictions on IOU forward contracting.
There is a fact that is very important.	FYI
