It's $3.00.	$3.00
You sent it to Kim instead of me, can you change it on the email?	Carmella, you sent this to kim ward in London instead of to me. Can you change it on= the email? thanks, Kim
What time do you want to meet?	of course - where do you want to meet? and what time?
I've asked if you can price that physical call for PNM at the money and less than the amount I've asked for in the past.	Can you price that physical call for PNM at the money and $.50 out of the money instead of what I previously requested? Thanks, Kim
When you get out of the meeting, please call me.	Please call me when you get out of your meeting
Just signed a Q2 gas deal.	just did a Q2 gas deal with LDWP.
Decreased to -20.	=20
The plans are interesting.	Here are the plans - interesting.
Are you talking aboutPhillips?	Phillips?
Kim, I haven't had the chance to read it yet, but I will when I do.	Barry, I haven't had a chance to review this but I will when I get in. Thanks, Kim
Kim got her fourth call this morning and asked, "What do we need to do to blend amgen?"	Just got my fourth phone call this morning - what do we need to do to blend amgen? Kim
"Jan Kennedy (E-mail)", which can be found at "Jan_Kennedy@ci.mesa.az.us".	To: "Jan Kennedy (E-mail)" <Jan_Kennedy@ci.mesa.az.us> cc:
Kim, we haven't heard from Dave yet, but if you could help us out, it would speed things up.	Mike, We still haven't heard from Dave - he may be wondering who Jason Williams from Enron is. If you guys could work him from you end, it could speed things up. Thanks for your help, Kim
Thanks, Kim, I will forward the room location to you once I get your confirmation, so you don't have to worry about that.	How is 10:30 am Wednesday, 8/29? I am having jessica reserve a room and once I get your confirmations, I will forward the room location to you. Thanks, Kim
I wonder if I can sell the Hesco Socal index for 300/d in October and June.	Can I sell Hesco Socal index for 300/d Oct through june 02?
I've been bugged by Tlapek for the last two weeks so hopefully you can use it.	Tricia Tlapek has been bugging me about this for two weeks now so here it is. maybe you can use it. Kim
Please let me know if you have any questions, Attached are the confirms for September and October, Lynn, please let me know if you have any questions.	Lynn, Attached are confirms for September and October. Please let me know if you have any questions. thanks, Kim
What are you planning to do with bhp in august?	What do you want to do with bhp for august?
I was wondering if you would show up to work today, I didn't want to hear about it.	ok, I was wondering if you came to work today. I certainly didn't want to! still sorry to hear about your deal. I hope things get better!
Thank you, Kim, for the attached letter, please give me your feedback on the cancellation as authorized market for the city of Pasadena.	Mary, Attached is a letter providing notification of our cancellation as authorized market for the city of Pasadena. Please let me know if you have any quesitons. Thanks, Kim Ward
There are only three garden homes inside the gate, and one is big on my double green doors.	It is right behind 3112. There are only 3 garden homes inside the gate - and 3110 is real big on my double green doors. Call if you get lost - 713-412-4571. Kim
I would appreciate it if you could tell me if any of the lawyers have seen the documents.	J. Barry wants to know if any of the lawyers have seen the documents provided by CDWR. Let me know what their take is. Thanks, Kim
I'm just working on what I can.	absolutely nothing. Just working on whatever I can. very slow. what about you? what are you doing thanksgiving?
Alright, let's do it ok.	ok
Kim, I have a client in town that night. I hope that we can get together soon.	Susie, Unfortunately, I have a customer in town that night. when it rains, it pours! Hopefully, we can get together soon. Thanks for inviting me. Kim
Kim, I need your help with John's questions about our capacity and deliveries to Nogales.	Stephanie, Can you help me answer John's questions regarding our capacity and deliveries to Nogales? Thanks, Kim
I will be in Arizona next Tuesday to meet with the Salt River Project, and I would like to take our comments with me. Where do we stand with this?	I will be traveling to Arizona for meetings next Tuesday and will be meeting with Salt River Project. I would like to be able to take our ISDA comments with me. Where do we stand with this? thanks, Kim
I'm available until 3 pm if you'd like to meet, just let me know.	I haven't heard from Ann yet but if you want to go ahead and meet, I am available until 3 pm. Just let me know. Thanks, Kim
I'm here.	ok - I am here
We are working up prices for you today, so please let me know if you need anything else.	Lou, We are working up some prices for you today. I will call you when we have those numbers. Let me know if you need anything else in the mean time. Thanks, Kim
I'm not on the phone anymore.	I'm off my call
Thanks again, Kim!	thanks again!! Kim
Do you know if there is any news on a one month deal?	any news on doing a one month deal with bhp?
I called both of your contacts on Friday and haven't heard back, is there anyone that works for either of them?	Hey, I called both of your contacts on Friday and have not heard back from either of them! Does Kristin Stanton work for either of them? Kim ps. I'm still at work - will know more by Monday
If you need anything else, please let me know.	Brenda, Attached are the price indications that you requested. Let me know if you need anything else. Kim Ward Manager, West Gas Origination 713-853-0685
They have to go through an act of congress to get anything signed, thanks to Kim, where are we with the Mesa document?	Stacy, Where are we with the Mesa document? They are extremely concerned - they must go through an act of congress to get anything signed. thanks, Kim
I am really embarrassed because I can't believe you figured it out! So I'm trying to nonchalantly check you out.	I can't believe you figured it out! Just trying to nonchalantly check you out! Now I'm REALLY embarrassed! Must leave town on that note -
How's this happening?	how's this
Are you sending them to Art?	Can we overnight them? and are you sending them to Art?
I'd love to hear about any questions you have for Palo Alto in December.	Palo Alto for December. Let me know if you have any questions. Thanks, Kim
As long as we don't go on halloween, I will be happy to take you to the mall. Have a great day, and I will see you later!	I will be happy to cruise the mall with you - as long as we don't go on halloween! Have a great afternoon and I will see you later! K.
Kim, thanks for your help in crossing the socal border.	socal border. Thanks for your help Kim
Kim, I have attached some of my changes.	Attached are my changes Kim
I had a deal with El Paso Electric to facilitate the Cal-02 deal and they also negotiated collateral terms and force majure language.	also negotiated collateral terms and force majure language with El Paso Electric to facilitate the Cal 02 deal I did with them
Thanks for the look, I appreciate it.	thanks for the look
You're welcomed, I hope you're having a good time.	You're welcome. I hope all is going well with you.
Kim, can you send our daily pricing email to bbuxa@igservice.com?	Amy, Can you add bbuxa@igservice.com <mailto:bbuxa@igservice.com> to our daily pricing email? Thanks, Kim
I will eat a lot of chocolate in the afternoon, at least it tastes better.	I threw most of mine away - now I will munch on chocolate all afternoon. At least it tastes better!
My company is awesome.	my awesome company
Hello, I'm very pleased to speak with you.	hello
I have a question and I need to hear from you.	Please call me when you get a chance. I have a question. thanks, Kimmie x30685
We are very close! when were you there? and why are you slummin on the gas floor?	we are VERY close! when were you here? and why are you slummin on the gas floor so much?
Check this out, http://www.headhunter.net/ share/det.asp?d=J42QS1MKNJ1V5Q1R06	check this out http://www.headhunter.net/share/det.asp?d=J42QS1MKNJ1V5Q1R06
Please give me a call about the threshold amounts listed in the draft.	J. Please give me a call asap regarding the threshold amounts listed in Glendale's ISDA draft. thanks, Kim
I have E.'s home email address, and I'd love to speak to you soon.	Garrett, I do have E.'s home email address - emainzer@attbi.com. Thought you might like it. Talk to you soon! Kim
As soon as you see what it looks like, you'll get a reply from cogan.	how does this look? will send to cogan as soon as you take a look.
He said you can, what's going on tonight?	yes - he said you can. What's going on tonight.
John John says hi as you log in, you have to sign in.	you have to sign in. you are logged out. John John says hi.
If you can set up the authorization for me I'll be able to make an appointment with you next Tuesday.	Jim, I made an appointment with Olivia for next Tuesday, if you can ge the authorization set up for me. thanks, Kim
Kim Ward Manager of West Gas Origination would appreciate if you could let me know if you have any questions.	Brent, Attached is my response to your RFP request. Please let me know if you have any questions - Thanks, Kim Ward Manager, West Gas Origination
Why are they doing this?	why are they doing this?
Did you meet him? What is going on this week?	He is canadian. Did you meet him? What's going on this week?
I would like to see what the deal is like and see if I can make as much money as possible.	Let's talk about that. I want to get the deal and make as much money as possible!!! So I would like to test it out and see what seems reasonable. thanks, Kim
From the other side of the pond.	From Fuller -
Scott Masuda from the Los Angeles Department of Water and Power will be in our office on Monday.	I forgot to mention that Scott Masuda of Los Angeles Department of Water and Power will be in our offices on Monday afternoon. Thanks, Kim
Kim said that Jeff at Merced told them not to stay late.	Sure!! Jeff at Merced said to tell you not to stay late!! Thanks, Kim
Kim Ward is my fax number, I am in Houston at 3206a, and Jessica Presas is my admin.	Jessica Presas is my admin and I am in houston at 3206a. this will change = Nov. 9. fax number is 713-464-2391 Kim Ward
After I got back in the office today, I forwarded your email to Patti Sullivan and Jan Sutherland so I will let you know once I hear from them.	I just got back in the office today after being out since the 12th. I have forwarded your email to Patti Sullivan and Jan Sutherland. Once I hear from them, I will let you know. Thanks, Kim
You can go to the beach with your pete.	goin to the beach w/ pete
I am going to send you a new email, so please let me know if you have any questions.	Jan, I tried to email you earlier but it didn't work. I will be sending you another email too. Let me know if you have any questions. Thanks, Kim
Dean and I were supposed to work out together this morning, but he was out of town and I missed the chance to work out with him.	As you probobly knew, Camille is gone. I missed working out with Dean this morning - oh well. Thought you might want to know about Camille.
I think you might have a phone in your car.	Do you have my phone? I think it might be in your car.
Did you think that I was bored today?	Wht do you think? I was really bored today
I would like to know if you can send me sally and susie's email addresses as well as stacy and your aol name. I had to relog on and it messed my thing up.	Can you send me sally and susie's email addresses as well as sally, susie, stacy's and your aol IM name? I had to relog on and it messed my thing up. thanks, K2
I need to go to my back office, so I want to be reminded of the changes.	Please remind me of the exact changes so I can go to my back office. Things have just been crazy around here so sorry for overlooking this. ' Thanks, Kim
Call me with any questions - thanks, Kim, Attached is a revised spreadsheet for the 19th and 26th.	John, Attached is a revised spreadsheet for the 19th and 26th. call me with any questions - thanks, Kim
Let's go now.	lets go now
Also, who is the boss of the person who does the smurfit invoice?	also, who use to do the smurfit invoice and who is their boss - do you know?
Chris, I want to make this consistant and pretty, but how does the spreadsheet look to you? Kim, they didn't take much during July.	Chris, Besides making this consistant and pretty, how does this spreadsheet look to you? Am I leaving anything out? According to the desk, they didn't take much during July. Thanks, Kim
THank you, it's awesome!	THank you!!!
We have to discuss September or I have to remove them from my pool by Tuesday.	I guess we need to talk about September. We need to roll the deal or I need to remove them from my socal pool by Tuesday. What are you guys thinking?
Kward frady18cat.	kward frady18cat
I'll let you know if you need anything else.	Let me know if you need anything else - K.
I want to be removed from your distribution list.	please remove me from your distribution list
Kim, can I change smurfit to september?	J. Can I roll smurfit to september? thanks, Kim
I want to know what you guys think about this one, can I get a response in order to put it away or pursue it?	what do you guys think about this one? Jay, we have talked about them before I think. Can I get a response in order to put this away or pursue? thanks, Kim
I'm going to work that way, please tell Jay if he'd like to go to Las Cruces.	ok. I'll work it that way. Jay here today? Tell him if he wants to go to Las Cruces, he needs to call me back. Where is the love?
I'm pretty sure that Ann took care of it last week, I want to know if there's anything I can do.	I am sure that Ann took care of this last week because some confirms were generated that came across my desk. Let me know if there is anything I can do. Thanks, Kim
Kim will be out of the country from October 17th to 19th.	I will be out October 17 - 19th. Kim
Here's my stuff, 3105 lake St. Houston 77098. Kim, good luck and please keep in touch.	e. Here's my stuff - 3110 lake St. Houston, 77098. 713-526-7117. kward1@houston.rr.com. Good Luck and please keep in touch. Kim
Kim, are you going to the happy hour tonight?	are you going to this happy hour tonight? =20 Kim
Is this a new email address for you?	Is this a new email address for you?
kimberlyward is a word used to describe the phenomenon of lydgate.	kimberlyward - lydgate
If you can't get through, try Kim.ward@enron.com.	Try kim.ward@ect.enron.com. If that doesn't go through, just try kim.ward@enron.com. Thanks for sending it to me! Take care - Kim
We talked about it and I think today would be a good day to send him off, with a wedding gift on his return.	Stephanie and I talked about this as well - I think lunch today would be a good send off and a wedding gift on his return would be in order.
Thank you for the invitation, I'll keep you posted. Last night was fun, we had just the right amount of trick or treaters and we had one piece of candy left over for each of us.	Hey Jeanie, thanks for the invite. Please keep me posted. Last night was fun. Had just the right amount of trick or treaters to have one piece of candy left over for each of us! Kimmie
I'm coming to Houston on September 8th to attend the matchbox 20 concert.	It's official - I am coming in on Saturday, Sept. 8. Missing the matchbox 20 concert here in houston!
J. Barry wants to know the credit status of the man he is going to meet with on Thursday.	J. Barry wants to know the credit status post the financial info I gave you yesterday. he is meeting with Mark Baldwin on Thursday and wants to prepare. K.
Let me know if you're interested in more, I'm sure I'll be able to get it for you.	This is all of the info that I have on these customers but I may be able to get more if it is valuable to you. just let me know. Thanks, Kim
I would like my email address removed from your distribution list.	please remove my email address from your distribution list.
I will try to make it, even though Stewart and Paul may not be here.	I will try to make it. Stewart and Paul Choi (PDX office) are suppose to be here but that may change. Either way, I will try to make it. Kim
I would like to change my United Way contribution to zero because Kathy is no longer with us, who should I send my request to?	Jeanie, I would like to change my United Way contribution to zero and it looks like Kathy is no longer with us. Who should I send my request to at this point? Thanks, Kim
Is it possible to tag with you guys if I needed a ride up there?	when? and if I needed a ride up there, could I tag with you guys?
Is it possible to get there after hesco additional collateral and Noresco's focus is on 10 or 20 years?	1) hesco additional collateral 2)Noresco - they want to focus on 10 or 20 years - can we get there?
I sent the website to my friend and asked if she wanted to hear what it had to say.	only you would know of a website that contradicts this! do you have too mu= ch time on your hands? I sent the website to my friend. Let's see what she= has to say!
There's a copy of master enfolio agreement and a letter that legal is going to send to Hesco about L-T contract recommendations.	this is a copy of the letter legal is planning to send to Hesco regarding L-T contract recommendations. They have a copy of master enfolio agreement. Any comments? Kim
I need to know if you'll send the letter by email or if I have to do anything.	Are you going to send the letter our or email it or do I need to do anything? thanks for your help, Kim
Suzanne, can you reach out to Joe and Joe's wife.	Suzanne, can you forward to Lori and Joe Gordon. Terri, Can you forward to Pierce, Stacy, and Donna?
I need a copy of the contract to get these invoices processed, but I don't have a copy, can you fax or send it to me?	Chris, Can you send or fax me a copy of the contract between us/Citizens and EARMS? I don't have a copy and i need one in order to get these invoices processed. thanks, Kim
Kim, how do we proceed?	Sara, FYI, how do we proceed? Kim
Did you send this to the wheelabrator?	Jay, Did you send this out to wheelabrator? Let me know - Thanks! K.
Matt, are you going to Dallas this week?	you (and Matt) going to dallas this week?
Did you ever get the information Sara needed to complete the process?	J., Where are we with this process? Did you ever get whatever info Sara needed to her? Thanks, Kim
We were talking this morning about what we need to have in place if we were to attempt to transact with these counterparties.	j., attached are contracts that I was discussing with you this morning. If we were to attempt to transact with these counterparties, short term or long term, what were we need to have in place to do so? Thanks, Kim
Kim, if you want to call him!	in the case that you want to call him! Kim
When I leave, I will call 7 or a little after, and I promise not to keep you up too late.	I will call when I leave - probobly 7 or a little after. And I promise not to keep you up TOO late!
I'm not on your distribution list.	please remove me from your distribution list
I wonder if it's to get an outside opinion.	Is this to obtain outside opinion? I thought we were going to do that at our own expense.
Will you review the manual invoice and decide if you agree based on the volume of information we have? Kim, let me know if you have any questions.	Mara, here is Janine's manual invoice for Septmeber. Will you review it and see if you agree based on the volume information we have? Let me know if you have any questions. Thanks, Kim
I am interested in knowing if you will send me the June spreadsheet that you are working off of.	Darla, will you send me and Ann Bike the June spreadsheet that you are working off of? Thanks, Kim
Kim, I will let you know if I hear from you after 2 pm, if I send another email to Ann.	I sent another email to Ann but I am available at 2:00 tomarrow. I will let you know if I hear from her. Thanks, Kim
I want to know if there is a special agreement in place for the full requirements gas deal.	So do we have a special agreement in place for the full requirements gas deal? I think that you did that deal before I came to the gas desk. How can I get a copy of the penalty language? Thanks, Kim
Oregon hasn't played anyone this year, so they'd be eaten alive by Miami.	But Oregon would be eaten alive by Miami - they haven't played anyone this year. Just got a call about a power originator job in Denver. Interesting!
We'll get together at 3:30 and then we'll call hesco at 4.	Ok - we will meet at 3:30 and call hesco at 4.
If you have any questions, please let me know, this is the most recent spreadsheet of deals I have done with Citizens.	Here is the lastest spreadsheet of deals I have done with Citizens. Please call if you have questions. Thanks, Kim
We should discuss our written response to Citizens today.	when can we meet today to discuss our written response to Citizens?
Yes, it is.	yes
713-646-2391 is a city in the state of Georgia.	713-646-2391
This appears to be ok to me, thanks, Kim.	This looks ok to me. Thanks, Kim
Kim, thank you for attaching my changes to the hot list.	attached are my changes to the hot list. Thanks, Kim
I wonder if you are flying into Iah, and if you are going to take one cab.	if you are on continental, are you flying into IAH? Maybe that is what I should do and we could take one cab. what do you think?
Did you put it on my desk?	did you put that on my desk?
I'm not interested in what's happening.	what's happening? I am bored.
I am still here, but I can't give out quotes at the moment. I apologize, I will be in touch once things are back to normal.	Lou, I am still here but I am unable to give out quotes at this time. Please accept my apologies and I will be in touch once things are straightened out around here. Kim
He's always nice.	yes - he's always nice.
How do you become an expert finder?	how do you get into expert finder?
I've got you on the phone right now with Hesco information, I'd like to conference you in.	I've got Travis on the phone RIGHT NOW with Hesco info. I want to conference you in
This appears to be fine to me, thanks, Kim.	This looks fine to me. Thanks, Kim
I can't remove your site because it has been blocked by my company.	lose this email address! your site has been blocked by my company and I can not remove as described below.
Kim, if you had a list of counselors, or if you were interested in setting something up, please let me know.	Jim, Just wondering if you had that list of counselors or if you were interested in setting something up. Kim
We have a couple of days to decide whether or not we want to work with them. Right now, they are only looking at Bal Aug, Sep, and Oct San Juan.	Any word on BHP copper? We have a couple of days to determine whether we can transact with them or not. Right now, they are only looking at Bal Aug, Sep, and Oct San Juan. Let me know Thanks, Kim
This is what Hutch said after I presented my fundies presentation.	This was Hutch's reaction to my fundies presentation.
I just got through the rubble from the train wreck and it looked like I was a big fat baby.	Looks like I am a big fat baby!!!!!!!! Just getting through the rubble from the train wreck! Looks like the weekend might be fun.
Call me on my cell phone if you take a look at this.	Take a look at this and call me on my cell phone
800-891-0151 is used for the reporting of any information regarding this matter to the Federal Trade Commission, the US Securities and Exchange Commission or any other federal agency.	800-851-0151
Dave will be working on this as well as sending them a Master.	We want to send them a Master - Dave will be working on this too. THANKS Kim
You can count me in if you want, but what can I bring?	You can count me in - what can I bring?
Kim, I'd like to know the name, phone number and other information of your bond council for our attorney, Sara Shackleton.	Steve, could you provide the name, phone number, etc. of your bond council for our attorney, Sara Shackleton? Thanks, Kim
Did you go to Christopher's? I'd like to pick up some wine if you need it, and where do you want to leave from?	of course, I'm just tagging with you guys. Did you ever go to Christopher's? I might go pick up some wine - any requests or recommendations? And where do you want to leave from?
Let's begin on what we can get started with since I don't have their financials.	I don't have their financials but lets get started on what we can get started with. I am not expecting to do financial swaps in the immediate term but I would like to be preparted when we are ready. Thanks, Kim
Were you able to find any information about the guarantee?	Were you able to find anything regarding BHP's guarantee?
Brad and I ran into P. at the loud bar after we got home from the party.	I went to this party with my friend Brad Fagan - we ended up at this loud bar and ran into P. - It wasn't much fun.
I made a few changes to the spreadsheet and I'd appreciate it if you would discard the other one.	Darla, I made a few changes to this spreadsheet. Please discard the other one that you have. Thanks, Kim
I asked Patti for the information and she never responded. will follow up and get the info tomarrow.	Chris, I asked patti for the information and she never got back to me. Will follow up and definitely get the info tomarrow. Sorry. Kim.
Please let me know if you have any questions, I'll price up an@ money call option for 1500/ day at Malin for July - October of 2004, if you'd like to do so.	Kelli, Could you (or someone) price up an @ the money call option for 1500/day (physical) at Malin for July - October, 2004? Please let me know if you have any questions! thanks, Kim
205-353-8511	205-353-8511
I was hoping it was good, I'm still on for tonight.	Hey, how was your weekend in Phoenix? Hope it was good! Are we still on for tonight? K.
kward1@houston.rr.com is the email address for kimberlyward.	kimberlyward - lydgate - kward1@houston.rr.com
It was from 3 - 4.	Thanks. from 3 - 4?
You're going to work out? Just tell me what time you're going to work out.	Sounds good to me! Just let me know what time. You gonna work out?
Kim will send Steve Lins an email today after he never heard from him after leaving a message for him.	No problem - left a message for Steve Lins but never heard from him. Will probobly send him an email today. Thanks, Kim
His email is mbaldwin@igservice.com and he's on the phone at 925- 243-0350.	I just left him ANOTHER message. his number is 925-243-0350 and his email is mbaldwin@igservice.com <mailto:mbaldwin@igservice.com>
Call me and let me know what's going on.	Please call me.
Can you send me the invoice for the griffith stuff for July? I think I need to make a change.	darla, can you send me the invoice for the griffith stuff for July? I think I need to make a change. Thanks, Kim
Thanks, Kim, could you give me the NCPA sheet of paper?	Kelli, Could you send me the NCPA worksheet? thanks, Kim
Kim - another one for you.	another for you - Kim
My email address should be removed from your distribution list.	please remove my email address from your distribution list.
Some of them are quite funny.	Some of these are pretty funny.
On Nov. 1st, 1916 16861 8932, there was a fatal accident.	Nov-01 12339 16861 8932
When?	when?
Do you want to go after work if you didn't go this morning?	Did you go this morning? If not, do you want to go after work?
If you're still interested, let me know if you need it broken down, I was out yesterday afternoon, but the product is just $5.06.	Monica and/or Karla, I was out yesterday afternoon but the price for that product, all in is $5.06. Let me know if you need it broken down and if you are still interested. Thanks, Kim
Please let me know the status of this document as a customer is asking for it.	Debra, What is the status of this document? Customer is asking for it. Please let me know - Thanks, Kim
Kim, thank you so much for your help!	Kam, Thanks so much for your help! Kim
I think this is the one for you, have a good day!	Finally, I think this one is for you! Have a good day! Kim
I would like to be removed from your email distribution list.	Please remove me from your email distribution list.
Why do Burbank pay the big bucks to this guy?	so what does this guy do for Burbank and why do they pay him the "big bucks"????
Is it you trying to confuse my customer?	are you trying to confuse my customer?
Kim thanks Susan for attaching the sample sample natural gas Master Purchase/Sales Agreement.	Susan, Attached is our sample physical natural gas Master Purchase/Sales Agreement. Thanks, Kim
Sean, I can't tell if you have any questions, but please send me an email with your request for a description of the steps that Enron is taking to improve flows to the power plant.	Sean, Attached is our response to your request for a description of the steps Enron is taking to improve flows to the Griffith power plant. Please let me know if you have any questions. Thanks, Kim
I will work on this for you, and you will be in touch.	I will work on this for you - and will be in touch. Thanks!
If you don't want to fax a signed copy, please let us know, we will send you the originals on the same day.	Karla, We are printing the confirms and signing them this morning and will fax them to you soon after. If a faxed signed copy is not ok, please let me know and we will send you originals overnight. Thanks, Kim
We are going to get the deal done.	We are going to get thsi Merced deal done!
K, call me!	call me! K.
Kim, let me know if there's any news on Hesco this morning.	Stacy, Any news on Hesco this morning? Let me know - Thanks, Kim
I came up with a value of $130,188, so please let me know if you need any more information.	Mark, I used the swap model to determine the present value of what the origination would have been. I came up with $130,188. Let me know if you need more details. Thanks, kim
I don't know if you are on the site, but I'm going to send you a message.	Mine says you are not logged on. Send me a message. Your boyfriend Dave Fuller says hi now.
Please let me know how things are going with your staff as well as with the Collateral section, thanks, Kim, Attached is a document with the changes we discussed.	Sean, Attached is a document with the changes we discussed. Let me know how things are going with your legal staff as well as with the collateral section. Thanks, Kim
Thanks, Kim!	Thanks! kim
Are you aware that I have a cell phone in my car?	Have you found my cell phone in my car yet?
This was very funny and I can't believe you remember that I have a cat.	This was hilarious! I can't believe that you remember I have a cat! How are things?
If there is anything else you need, please let me know.	Sean, According to Patti, gas will flow on an interuptible basis to Nogales from the Waha pool. Let me know if there is anything else that you need. Thanks, Kim
It was done, worked, worked, worked, worked, worked, had worked, worked, worked, had worked, had worked, worked, worked, worked, worked, worked, worked, worked, worked, worked, worked, worked, worked, worked, worked, worked, worked	worked
We could meet at my house and then go for a walk. I could go home by 6.	We could meet at my house and sit on my patio. I should stick around until 5:30 or so. I could be home by 5:45 or 6. Is that cool?
Is Dean going to work with us?	are we going to work out with Dean tomarrow?
There's no excuse for this $353 you've got no excuse!	http://www.orbitz.com/App/PerformFlightSearch?cache=1009468919716&requestId=57&lastPage=interstitial $353 - you have no excuse!
I guess it should go in as an annuity, would you be interested in having me speak to Ann Bike?	I don't know - maybe we should talk to Ann Bike. I guess it should go in as an annuity. Would you like for me to talk to Ann?
Kim, talk to you then, tomarrow is fine.	tomarrow is fine. Talk to you then. Kim
Kim.ward@enron.com is the email address for kward.	kward kim.ward@enron.com
Did you go this morning? I need to take drugs to sleep.	Did you go this morning? I need drugs to sleep at night.
I would like to remove my email address from your distribution list.	please remove my email address from your distribution list.
We need to leave to make 1:45.	what time do we need to leave to make 2:45
$3.18 does not include origination.	$3.18 plus origination
Are you still here?	you still here?
Kim, call or come by to ask your question, I have a question on the blend.	Call or come by when you get a chance - I have a question on the blend & extend Thanks, Kim
It was fun and busy, I was happy to see everyone and hangout with Harriet and Angie for more than a few minutes.	It was very fun - and busy. Glad to see everyone and to hang out with Harriet and Angie for more than a few minutes. how was your weekend? Did you go to greenwood?
Janey, I would like to know if you will respond to Bob Pettinato regarding this agreement or not.	Janey, Are you planning to respond to Bob Pettinato regarding this agreement or shall I? thanks, Kim
Attached is a spreadsheet with gas prices and volumes.	Attached is my spreadsheet with the actual volumes and Gas daily prices. Let's discuss. thanks, Kim
We aren't able to pay them anyway.	thats fine - we can't pay them anyway
Credit being all work and no play is just not correct, as I saw you at the baseball game last night.	Saw you at the baseball game last night. Credit being all work and no play is just not true!
