We just got off the phone with the lawyer and we have only minor comments. I will let you know when I'm able to send out a revision.	Just got off the phone with the lawyer. We have only minor comments and he needs to check with his credit people regarding the collateral threshold. I will wait to hear back before sending out a revision. Sara
Thank you for asking, can you submit a new credit worksheet?	Can you please submit a new credit worksheet? Thanks.
That's a good thing.	FYI
Please tell Sara how to do it.	Please advise. Sara
Do you have any information on the status of the Duke confirmation or a copy of the final confirm?	I've received a number of e-mails regarding the Duke confirmation. Would you please advise as to status and send me a copy of the final confirm?
The phone is needed due to the language problem, but the rest is in Lotus Notes.	Per my email, you will need Julian on the phone due to the language problem. All else is in Lotus Notes. Sara
I can't remember if you recall the name of the Delaware business trust that ECT executed a master with.	Do you recall the name of the Delaware business trust (which owned the oil and gas assets) that ECT executed a master with? My memory is shot. SS
Please review the tax reps as soon as possible.	Please review the REVISED tax reps ASAP. The deal funds tomorrow am.
I've received a few messages but have not heard from the right person. Why is it a swaption?	Yes, I've received messages but have not heard from the right person. However, I want to clean up the transaction itself. Why is it a swaption? ss
The developer was Elizabeth Serralheiro.	Elizabeth Serralheiro@ENRON_DEVELOPMENT 12/06/99 09:42 AM
Sara, do you want to deal with it?	do you want to handle? Sara
Please! Sara!	Please! Sara
Sara, can you help get the credit going?	Credit has not received financials. Can you help out here to get the ball rolling? Sara
The banken is referred to as Skandinaviska Enskilda Banken.	Skandinaviska Enskilda Banken AB
I wanted to let you know that I am going to have the agreements executed by ENA once you return them to me.	Hi, Susan. Just to let you know that I will have the agreements executed by ENA once you have initialled and returned them to me. Thanks. Sara
Sara, please provide the following individuals with Lotus Notes access.	Tana: Please provide the following individuals with Lotus Notes access. Thanks. Sara
The draft letter was attached to my voice mail.	Per my voice mail, attached is draft letter.
I'll be gone for a while.	I'll be on vacation. Sara
I hope this works, I tried to tie all to the specific confirm.	I hope this works - I tried to tie all to the specific confirms.
I would like to talk to Clement Abrams, but I think ENE will not accept FIMAT's form.	no - this should be for FIMAT USA, Inc. right? can you fax their form of guaranty to Clement Abrams and I'll speak with him? I don't think ENE will accept FIMAT's form.
Please use the attached form of the schedule to prepare an ISDA comparison for SMUD.	Please prepare an ISDA comparison for SMUD using the attached form of Schedule. Stewart Rosman is Enron's commercial contact in Portland. SS
It's best for me if you have John S. available.	Friday is best for me. I think you should have John S. available. I'll make sure that Jason is available by phone. SS Per Sekse 08/09/2000 12:14 PM
Sara, I have a few fires and will call you at 3 and I have until 2:30.	Sounds good. I have a few fires but I will call you at 3 (your time) and I have until 2:30. Sara
Please use a typewriter to print it out.	Please print
I'll be in Argentina next week, and I think that Tanya worked on this.	I think Tanya worked on this. FYI, I'll be in Argentina next week. SS
I'd like to know if you'd be able to handle EIM, Susan has a lot of information.	Bob: Can you please handle for EIM? Susan has a lot of information. Also, it is my understanding that any information going out the door must be logged in by Raz. Thanks. Sara
I have called him to let him know that I've asked him to give you a call.	John: Thanks for your message. I have asked Brent Hendry to give you a call. Hope you're doing well. Sara
Please give us notice and account information for the confirmation that is going to be sent out to Joe and Souad.	Please provide and notice and account information for the discussed confirmation to both Joe Hunter and Souad Mahmassani. It will be inserted into the confirm No. NQ9331.1,.2. Thanks. Sara
Please open the new file and let the assistant know which one it is.	Please open new file "Project Spector" (or Spectre?) and print the docs below. Gareth Bahlman's assistant should know the name. Thanks. Sara
I'm fine with that, and I'm waiting to hear from Susan.	fine with me and I'm waiting to hear from Susan
As we sort through the structure, please keep this in mind.	FYI as we sort through this structure.
I can't seem to figure it out.	fyi
Does anyone know of any comparisons I can give to the other person?	Does anyone have any ISDA comparisons that I can give to Jason? Sara
There is a need for attachment.	need attachment
Sam is working with PrimeTrade to negotiate a futures agreement with Lotus Notes.	Sam: We do need to enter into Lotus Notes. I am negotiating the futures agreement now together with PrimeTrade. Thanks. Sara
Please add Samantha to the list since she will be assisting us with these accounts.	Thanks for the heads up. Also, please add Samantha Boyd to the list since she will be assisting us with these accounts. Thanks. Sara Sheila Glover 06/22/2000 09:02 AM
This is the only info that I have on this person.	Here's the only info that I have on this counterparty. Sara
If Friday, May 12 is an acceptable date for your group, please let me know.	Jeff: Per my voice mail, please let me know if Friday, May 12 is an acceptable date for your group. This works fine for Settlements. Thanks. Sara
I'll let him know that it's going to happen. Mike contacted me to inquire about it and I'll let him know it's going to happen.	FYI - Mike Ettringer from Portland called to follow up on this ISDA. Not to worry, I'll let him know it's in the works. SS
I will be at the doctor's office at 8:30 am, so I'll leave you a message if you need anything.	I have an 8:30 am doctor's appointment on Wednesday, Oct. 27. I'll leave the number with Kaye if you need anything. Sara
There is a good reason for that.	FYI
Referring to the same thing.	resending
I put several broker agreements in the database yesterday, but only one electronic trading agreement is in the "Other Agreements" section.	Tana: I added several brokerage agreements to the database yesterday and all ended up in the "Other Agreements" section. Except for one, which is an "electronic trading agreement". Can I call our developer? Thanks. Sara
Merrill Lynch Canada Inc., Merrill Lylnch Govt. Securities Inc., Merrill Lynch Fenner & Smith Inc., and UBS Warburg LLC are the companies that are involved in all of these resales.	These are all REPOS: Merrill Lynch Canada Inc./ENA Merrill Lylnch Govt. Securities Inc./Merrill Lynch Pierce Fenner & Smith Inc/ENA UBS Warburg LLC/ENA
Love, sah ah ah ah, ah, ah, sah, sah, sah, ah, ah, ah, sah, ah, sah, ah, ah, ah	Love, SAAAAAAAAAAAAAAAAAAAAAAAAAAAAAAAAAAAAAAAAAAAAAAAAAAAAAAAAAAAAAAAAAAAAAAAAAAAAA AAAAAAAAAAAAAAAS
I appreciated your help and I'm working on trading voice mails with Khymberly.	Thanks very much for your help. I am trading voice mails with Khymberly. Sara
Please call Tana if you want to discuss NYMEX hedge exemption and related issues.	Please schedule a meeting with Tana (at her convenience) to discuss NYMEX hedge exemption and related issues. Thanks. SS
I will be unable to make the meeting tomorrow, but I have no changes to my list from last week.	I will be unable to make the meeting tomorrow. I have no changes to my list from last week. Thanks. Sara Elizabeth Serralheiro@ENRON_DEVELOPMENT 03/27/2000 05:30 AM
I will be called for jury duty on January 16, 2001.	I have been called for Jury Duty on January 16, 2001.
I'll have it marked if you give me some advance warning.	3801a. Give me some advance warning so I'll have it marked. SS
Sara, thank you, by the way.	by the way, THANKS. Sara
Sara, please tell me the name of the company this is for.	Sheila: Please remind me which Enron company this is for. Thanks. Sara
Sara, who will be handling P&G this go-round?	Who will be handling P&G this 'go-round? Sara
There was no credit support annex, that's why the guaranty was capped at $25 million.	No credit support annex. Enron Corp. guaranty capped at $25 million. That's the latest (for Lehman, etc.)
Let me know what deadline you're after.	Of course. Just let me know what deadline you would like. SS Julian Poole@ENRON_DEVELOPMENT 01/28/2000 07:27 AM
Sara, will you be able to handle it?	Susan: will you please handle. Thanks. Sara
Russ will be asked to make sure that you get the draft Sara.	Jim: I thought Enron Corp. would prefer to have an Enron Corp. lawyer review the form of note. I will ask Russ to ensure that you receive the draft Sara
I'm going to put back on the paper. we've signed it; it's their paper.	Tanya: my mistake. I'll put back on. We've signed; it's their paper. Sara Tanya Rohauer 06/01/2000 09:51 AM
Sara, how do you want to handle it?	Elizabeth: How do you want to handle? Sara
I have asked Susan B. and Susan F. to prepare a list similar to Marie's list for delivery by the end of the day Thursday.	Attached is revised summary. Also, I have asked Susan B. and Susan F. to prepare a list similar to Marie's list for delivery by the end of the day Thursday. Sara
Gary asked if I wanted his credit person to be copied, and I said no, I was not sure who he would be preparing credit for.	I received a call again from Gary Ordway. Who will be preparing credit? Gary asked that his credit person be copied and his name is John Fryer. Thanks. Sara
Dale, can you have someone look at the terms? I'm not sure if it's a swaption.	Dale: can you have someone review the transaction terms. I'm not sure that this is a swaption. I'll also take a look. I do not have a voice yet but I am in the office. Sara
I will be in a seminar tomorrow, but I need to remind you.	Just a reminder. I will be in a seminar tomorrow. Sara
We're close to being ready - a few more minutes.	We're almost ready - a few more minutes
Sara: Is it possible for you to send the deal ticket for this transaction?	Laurel: Can you send the deal ticket for this transaction? Sara
Roy and Sara should call each other.	Roy: Call me and let's coordinate. Sara
I may have some questions about this deal, are you okay with it?	Are you OK with this deal? I may have a few questions. SS
Don't worry, Dale Neuner.	Don't worry Dale Neuner on 06/30/99 07:57:09 AM
It sounds great but I'm taking a few days off and won't be in town.	Shari: It sounds great but I'm taking a few days off and won't be in town. Thanks. Sara Shari Stack 12/04/2000 10:45 AM
I have tickets for the show at the theatre and I'd love to sell them to you.	I have two (2) tickets for "Wit" playing at the Alley Theatre for Friday, Feb. 11 (8 pm, Sec. 4, Row G). Let me know if you are interested. No charge. Sara
We can talk to Rolo when you're free. I've looked at their comments.	Call me when you're free and we can talk to Rolo.. I've looked at their comments. Sara Enron North America Corp.
Sara will be negotiating with this master.	FYI - we will be negotiating this master. Sara
I think this works for the group, including Taffy and Mark.	I think this should work for the group (including Mark and Shari) Taffy Milligan 03/09/2000 05:28 PM
I don't have a name or anything, but I have the copy of the confirm that has no comments.	I'm glad you're checking up. The copy of the confirm that I have HAS NO COMMENTS. I have no name either. What are the issues? Sara Jennifer Shipos 08/22/2000 01:12 PM
I'll be happy to check it out if you need it.	I'll look at now if you need it.
Is there something that you can send that I can't see?	Tana: Please see Sami's message below. Is there something you can send? SS
Marie and I would like to know who your credit approval person is.	Who is your credit approval person? Please have that person email or call Marie and me.
Is it possible for you to print this?	Joanne: can you print this?
Thanks a million, Sara!	Thanks a million! Sara
Sara Dale Neuner will be happy to assist Lucy during her absence.	Per our conversation, I'll be happy to assist Lucy during your absence. Sara Dale Neuner on 07/01/99 08:26:51 AM
That's correct.	FYI
Sara, did anyone ever do credit, after getting another call from Gary Ordway asking for an ISDA and our GTC's?	All: I received another call from Gary Ordway asking for an ISDA and our GTC's. Has anyone ever done credit? Sara
sara, did I send this to you already?	did I already send this to you? sara
Sara Dranguet, Beth Ann, thanks so much!	Thanks so much! Sara "Dranguet, Beth Ann" <badranguet@velaw.com> 12/15/2000 04:20 PM
I don't know if the deal could be affected by the accounting treatment.	AA has real problems with loans disguised as swaps. Who is reviewing this from an accounting viewpoint? The accounting treatment could impact the deal. ps. I'm leaving for a 1-week vacation on Friday, Oct. 1
Sara, if you want to do anything at this time, do you want legal to do it?	Ed: Do you want legal to do anything at this point? Sara
Here we go again!	Here we go again!!!!!!!!!!!
Sara was sent a CSA by Salt River.	Jay: my mistake - Salt River did send a CSA (see below) Sara
Dale had a voice mail from Sara.	Dale: Per my voice mail. Sara
Please make sure you print all of it.	please print all
The documents are from energy services provider, HS Energy Services.	HS Energy Services docs
Sara, please fax a copy of Rule 35.1(b) (2) to James Coiley.	Susan: Please fax a copy of Rule 35.1(b)(2) to James Coiley (outside counsel). Thanks. Sara
Mary and Sara haven't tackled this version yet.	Mary: We have not tackled this version yet. Sara
Carol may have seen this a few months ago, isn't that related to Jean Mhra's request?	I think that Carol may have looked at this several months ago. Isn't this related to the request of Jean Mhra? Enron North America Corp.
Mark, do you have the power to give to the other person?	Mark: Can I go ahead and give to Angela? Sara
Thanks for reminding, Carol St. Clair has the VEPCO proposal in hand, and will contact you soon.	Carol St. Clair has the VEPCO proposed guaranty in hand and will contact you soon. Thanks for reminding me. Sara
I'll be able to talk to you in the morning.	I'll talk to you in the morning. Sara Melissa Ann Murphy 12/21/2000 04:47 PM
I understand that you are concerned, but I agree that your future position is part of the agreement.	I understand your concern but negotiating your future position is part of the agreement. Holli Krebs 12/12/2000 01:34 PM
We need to ask for a legal opinion from the Deseret confirmation.	Where in the Deseret confirmation do we request the legal opinion? Did we send a sample? Sara
I need to speak to you but I need you to give me a call.	Did you understand my message? Please give me a call. S
Sara, have you seen this? I need to hear from you.	John: Have you seen this? Please call me. Sara
Print for Carol.	print for Carol
Please note room changes and your name if you want to send an update back to V&E.	Please send update back to V&E. Note room change and YOUR NAME and info. Thanks. Sara
I need the floating price index language for power and gas, so I need you to fax or email it to me.	Per my voice mail, you can see the floating price index language (power and gas) that I need. Please email or fax so that I can insert it into my draft confirm. Thanks. Sara
I would appreciate it if you could give me 4.	I would like 4. Thanks. Sara Taffy Milligan 09/07/2000 11:02 AM
Dale prepared the doc before he left town. I have a question about the schedule and will give you a call later.	Dale prepared the docs below before he left town. I have a question on the Schedule and will give you a call later. SS
I sent the CSA and the correspondence to you so you know what's going on.	FYI - I faxed latest CSA and correspondence to you for our conference call tomorrow. SS P.S. Do you know what the problems are? I haven't heard a word.
Sara, give me a call, here's my goof!	Here's my goof! Give me a call. Sara
Sara "Bill C. Scott" will call you at 2pm on June 1st.	Bill: I'll call you on Thursday, June 1 at 2pm MST. Thanks. Sara "Bill C. Scott" <WCS@modrall.com> 05/30/2000 06:49 PM
I think that's correct.	FYI
I wasn't sure if Clint had forwarded it to you.	Jim: I didn't know if Clint had already forwarded this to you. Sara
Rod: Jeff Nogid asked for an agreement with the other party for equity and fixed income deals.	Rod: Jeff Nogid has also requested an ISDA Master Agreement with the foregoing party for equity and fixed income deals. Thanks. Sara
As promised.	as promised
I had lunch with a private eye in Houston and he said things had slowed down a bit here. Have a great weekend.	Of course it works! Had lunch just now with Carson Llewellyn. He's in private practice in Houston and said things had slowed down a bit here. Have a great weekend. SS Enron Capital & Trade Resources Corp.
Sara, I would like to ask you to send David an example of a confirm with the GTC's.	Melissa: Would you please sent David an example of a confirm with the GTC's (standard Annex A). Please cc me. Thanks. Sara
It's something that's very interesting.	FYI
Please let me know if you'd like to send a message on this one as well.	Sheila: Please send your usual message on this one as well. There are several written agreements involved. Thanks. Sara
2, 3 and 4 were all on the same day.	2,3 and 4
Please let me know if you have something to say and I will discuss it further.	Let me know if you have comments or want to discuss further. P.S. to Rod: We need to talk about Basin
Carol, this is a top ten. There have not been entries in Lotus Notes in over a year.	Carol: FYI - this is a Top Ten. There are no entries in Lotus Notes since 5/5/00. Hope you had a nice weekend. Sara
Can you let us know if you're able to send it to him?	Can you check on this and send to Brent? Thanks. SS
It's fyi.	fyi
The list is from Brazil.	Attached is the origination list from Brazil. SS
I am on the list for a flu shot, I need your help putting me on it.	Please put me on the list for a flu shot. My ext. is 35620. Thanks. Sara
Here's the information I just received from the "ECT trader" in Buenos Argentina, that is, if you want to know more.	FYI - here's the info I just received from the "ECT trader" in Buenos Aires!!!!!!!!
Sara, please tell me what happened with this.	Susan: Please let me know what happened with this. Thanks. Sara
"Susan Hopkinson" susan.hopkinson@lovells.com> was fax number 713-646-3490	fax: 713-646-3490 "Susan Hopkinson" <susan.hopkinson@lovells.com> 10/03/2000 07:53 AM
I'll let you know what I learn from your help.	Thanks for your help! I'll let you know what I learn. SS
Susan, I would like to ask you to prepare a 2 way C.A for the consulting arrangement between ENA and Dr. Haigh.	Susan: Could you please prepare a 2-way C.A. in connection with a consulting arrangement between ENA and Dr. Haigh. Thanks. Sara
I'm waiting to hear from you but I don't know if the proposal you have attached accurately describes what you want.	Still waiting to hear from you. Attached is a refinement of your proposal but I don't know if it accurately describes what you want. SS
Sara: I'm not sure if I'll call you, I'm not sure if you'll say anything, but the big difference in the way government and corporates are treated is something that I am not sure if I'll say anything about.	Chris: Please call me and let's discuss. My hesitancy comes from the big difference in the ISDA for general corporates and GOVERNMENTALS (which you know are treated differently). Sara
I need the information for the Grizzly I account.	Scott: I need the Grizzly I account information. Thanks. Sara
Thanks, from the person who said "Thanks!": The person who said "Thanks!": The person who said "Thanks!": the person who said "Thanks!": the person who said "Thanks!": the person who said "Thanks!": the person who said "Thanks!"	Thanks! Tanya Rohauer 06/29/99 09:12 AM
Also to Morris Clark and Steve Douglas.	jointly to Morris Clark and Steve Douglas
Holly will try to get something to EWEB today. Sara has to create a form because we don't prepare deemed ISDA's for muni's.	Holly: I'll try to get something to EWEB today. Also, we don't prepare deemed ISDA's for muni's so I have to create a form. Sara
If you have priorities please let me or Susan know, as I will be updating your list based on legal/credit meetings and requests for master agreements.	Fred: I am continuing to update your list based upon legal/credit meetings and requests for master agreements. If you have priorities, please let me or Susan Flynn know. Sara
I don't know what's going on.	fyi
Kaye Ellis needs to check with Lucy to get on her calendar.	Lucy: Check with Kaye Ellis (X35968) and get on my calendar. Sara Lucy Ortiz 08/28/2000 01:59 PM
Sara, can you refresh my memories?	Marie: Can you please refresh my memory? Sara
This company was booked with ENA in 2000 for a July-August deal.	ENA booked a July-August, 2000 deal with this counterparty. Is this company a municipal? Have you agreed to governing law and arbitration? SS
I have no idea what the other confims are.	Here are the only confims that I know of.
If something comes up I'll be in the office for the next few days, capitalized the words "Exemption" and "Eligible swap Participant".	Under "Legal Issues ...", the fourth bullet point: capitalize the words "Exemption" and "Eligible Swap Participant". I'll be in the office for the next few days if something comes up. Sara
I need to speak to Philip Levy, so I'm asking you for a call after Thanksgiving.	Did you have your questions answered? I have a voice mail from Philip Levy and need to respond. Please give me a call after Thanksgiving. Thanks. Sara
I messed up your names on the original message.	Sorry, I missed your names on the original message. SS
If you are having a question, please come in my office. I can give you a "yes" or "no" answer.	So you were able to put Janet in her place! If you have questions, please come in my office. I can write and shake my head "yes" or "no"! Sara
Susan wondered if Suttle had another contact after Fred said to send to Jerry Brunner.	Susan: Fred says to send to Jerry Brunner, PO BX 737, Ignacio, CO 81127 phone is 970-563-0140 Does Suttle have another contact?
No.	no
Does this document exist and is it possible you have a copy?	Does such a document exist and, if so, do you have a copy? SS
If this is finalized during my absence, I have asked for your assistance in providing certificates, etc.	Stephanie: Harvard's outside counsel is in control of drafting this document. If this is finalized during my absence, I have asked that you help to provide certificates, etc. Thanks.
Sara Jim Armogida, thanks for following up, she can be reached at 888-666-1846 888-666-1846 888-666-1846 888-666-1846 888-666-1846 888-666-1846 888-666-1846 888-666-1846 888-666-1846 888-666-1846 888-666-1846 888-666-1846 888-666-1846 888-666-1846 888-666-1846 888-666-1846 888-666-1846 888-666-1846 888-666-1846 888-666-1846 888-666-1846 888-666-1846 888-666-1846 888-666-1846 888-666-1846 888-666-1846 888-666-1846 888-666-1846 888-666-1846 888-666-1846 888-666-1846 888-666-1846 888-666-1846 888-666-1846 888-666-1846 888-666-1846 888-666-1846 888-666-1846 888-666-1846 888-666-1846 888-666-1846 888-666-1846	Jim: Thanks for following up. Sara Jim Armogida@ENRON 11/28/2000 09:49 AM
We really need to finalize with Bank One by Friday so please stay in touch with Sarah.	Jason: Please stay in touch with Sarah. We really do need to finalize with Bank One by Friday!!!!!!!!!!!!!!!!!!!
I need to be clear in Lotus Notes and the files for reference, so please let me know if you go to ENA, Enron Corp., or ECT Investments.	LaureL: Please let me know where you end up (ENA, Enron Corp., ECT Investments) so that I can be clear in Lotus Notes and the files for future reference. Thanks. Sara
Sara, I haven't reviewed it yet, but here it is!	I haven't reviewed yet but here it is! Sara
An amendment to this master agreement will remove references to the " " "	Please prepare an amendment to this master agreement which deletes reference to the "pari passu" language. Thanks. Sara
Does anyone else have to see this?	Remember this one? Does anyone else in underwriting need to see this? SS
I don't know what's going on.	fyi
Please let me know if you're having a problem with John's status.	Please email John re: status. Thanks. Sara
It came from my voice mail.	Per my voice mail.
Is it the Issda?	ISDA?
Mark, I would appreciate if you could reply to one of the following questions: Also, any suggestions for help with the broker agreements?	Mark: Can you please reply to (1) below? Also, any ideas for help with brokerage agreements? Thanks. Sara
Happy New Year, did we ever do a back-to-back deal for this transaction?	Happy New Year, and, did we ever do a back-to-back (RMT/Enron Comercializadora Argentina) deal for this transaction?
I'll need my prior markup for Monday, so I'd like to know if it's TODAY or Monday at 9 am.	How about TODAY or Monday at 9 am? I'll need my prior markup. Sara Samantha Boyd@ENRON 10/27/2000 03:02 PM
I'll call you in the morning, it sounds great! Sara "virginia.hodge@painewebber.com"	Thursday sounds great! I'll call you in the morning. Sara "Virginia Hodge" <virginia.hodge@painewebber.com> 11/27/2000 11:04 AM
Please review the blackline. London is screaming about it. I'll try to hold a conference call on Monday.	Please review the blackline. London is screaming about this!!!!!!!!!!!!!!!!! I'll try to schedule a conference call for Monday. Sara
Please check out the first draft to see if you have any issues.	Kevin: This is set to close tomorrow (so far!). Please look this first draft over to see if you have any issues. Thanks. Sara
John: Sara said that he would not be in the office until Wednesday.	John: Jason is out of the office until Wednesday. Sara
That's correct.	FYI
I need to put my calendar on.	pls put on my calendar
The swap includes a sample floating price language.	Attached are sample templates for ISDA confirms which you requested. The swap (first template) includes sample NG Floating Price language. Sara
I'd like to chat with you before I speak to you.	Before I respond to Shari, I would like to chat with you, please. Thanks. Sara
Flynn eagerly volunteered amendments she's got lying around, but I'm indifferent, I wonder if she's simply trying to use the system.	Neither Susan has any comparisons. Flynn eagerly volunteered amendments she's got lying around. I'm indifferent although I wonder if Flynn is simply trying to use the system.
Sara David P Dupre asked that her email not be forwarded to Bank One.	We are currently in negotiations with them. Please do not forward my emails to Bank One. Sara David P Dupre 06/30/2000 10:51 AM
We were sorting through issues relating to Canadian regulated entities, which is almost ready to go, as I have three ilities almost ready to go.	I have three utililities almost ready to go; we were sorting through issues related to Canadian regulated entities. SS
Sara is available as well.	I'm available as well. Sara
Please fax the original confirm.	Please fax the ORIGINAL confirm. Thanks. SS Jorge A Garcia@ENRON 10/20/2000 02:17 PM
There is something to be said.	FYI
Kim, do you want to work on the revision for this deal?	Kim: Do you want to take a stab at the revision for this deal? Sara
I think you have this agreement as well, can you please bring me up to date?	Jason: I believe you have this agreement as well. Can you bring me up to date? Thanks. sara
I'll be out of the office for a couple of days.	I'll be out of the office on Sept. 27 and 28.
Sara, I need you to negotiate with power counterparties and I have several confirms with them. Bob, don't forget!	Bob: Don't forget! I have several confirms with power counterparties that I need you to negotiate. Thanks. Sara
We are going to be on for Thursday.	We're on for Thursday. Thanks. sara
Julia, don't do anything yet because I am putting together the package for this afternoon.	Julia: don't do anything yet as I am putting together the package for this afternoon. Sara Julia H Chin@ENRON 07/25/2000 08:59 AM
JoAnn Dobson is listed on the side of the building.	Joann Dobson 212/469-2577
Can you eat lunch at noon?	Can you eat lunch at 11:45? SS
Attached are my financial power deals.	Attached is my list of financial power deals. Are there others?
The tax Ed Quinn put on was on 08/09/2000 at 02:58 PM.	Libby Rutherford - legal Irene Yates - tax Ed Quinn 08/09/2000 02:58 PM
Susan: I would appreciate if you forward your two emails to Bill and John.	Susan: Please forward your two emails (re: HS Resources,et al) to Bill Bradford and John Suttle. SS Susan Flynn 07/06/2000 07:35 PM
Sara "Charles O'Brien" is getting the package together for you.	Chuck: We are getting the package together for you. Sara "Charles O'Brien" <CHUCKO@statoil.com> on 04/20/2000 06:21:21 AM
Do you have an idea of what's going on?	Now do you see what's going on?
I was wondering, what were the dollar amounts that you sent to me?	What were the dollar amounts on the printout that you sent to me? David P Dupre 05/24/2000 06:06 PM
Please put it on my calendar.	Please put on my calendar
I will be here.	I'll be here. Sara
I received a document entitled "Third Party Connection: Customer Profile" in my inter-office mail.	A document entitled "Third Party Connection: Customer Profile" showed up in my inter-office mail. What is this in relation to? What company? Who requested? Why? Thanks. Sara
Cyntia Pastega, the business person, is the one you should contact since Rod is no longer with you.	Tana: look in lotus notes. I think you should contact Russell for Canada (since Rod is gone). Cyntia Pastega is the business person. SS Tana Jones 07/14/2000 02:27 PM
Per is the originator of hedge funds and we left a message for him.	Cathy and I left a message for Per since he originates hedge funds. SS Tana Jones 08/04/2000 09:16 AM
Sara: Please see me so that we can make a final decision.	Stephanie: Please see me so that we can finalize. Sara
613-646-3490 was the subject of a recent article.	713-646-3490
You can call the person who answered the phone for more information.	yes, you can call Laurel for details. Samantha Boyd@ENRON 09/19/2000 03:03 PM
Sara, can you please make an addition after the brackets for terminated value, a period and the word "valuator" on it?	Becky: can you please make an addition: After the the termination value brackets, put a period and add: "A valuation sheet is attahced." Thanks. Sara
The draft had already begun, and I had received the message this very minute.	Just received this message this very minute. The draft already went. Sorry.
Thanks for your help, Sara.	Thanks for your help - Sara
I'm not sure what to make of it.	fyi
Kaye: be careful about my vm about John Stoner in California because I may have this meeting which is more important.	Kaye: re: my vm about John Stoner in California, BEWARE as I may have this meeting (which is more important)!!!!!!!!!!! Maybe Stoner can be at the end of the day here.
Replacement changes for paragraph 2 of confirms for the referenced products were attached to my voice mail.	Per my voice mail, attached are replacement changes for paragraph 2 of confirms for the referenced products. SS
Mark, I'm wondering if you would like to speak to the group or not.	Mark, we should rotate the desk (as per this email). Shall I speak to the group or would you prefer to do it? SS
Is the account issue resolved? I'm worried about cash control and the ENA examiner.	Has the account issue been resolved? I'm concerned about the ENA examiner and the cash control situation between ENA and Enron Corp. Sara
I'm not sure what to think.	fyi
I'd appreciate it if you could print these for me.	please print these for me. thanks. ss
Thanks for the reply, Paul!	Thanks for the reply! Paul Simons 03/18/2001 07:36 AM
It's something I would like to point out.	FYI
You should start putting away money on a regular basis if you want to be rich one day.	FYI - You ought to choose one of these and start putting away money on a regular basis. You'll be rich one day!!!! Sas
Let me know if you need anything else.	Here is the list of Houston traders. Let me know if you need anything else. Sara
Is it possible thatBrent can handle this on his own?	Can Brent handle this himself?
Sara, can you tell me if any issues that I might address would be of particular use to your group?	Jeff: Are there any issues that I might address that would be particularly useful or timely for your group? Sara
Kim asked, shouldn't all of the financial power templates provide for correction to published prices and rounding to four places for commodities quoted in MMBtus?	Kim: A very general question: shouldn't all of the financial power templates provide for corrections to published prices and rounding to four places for commodities quoted in MMBtus? Your template does not contain either of these.
Ellen asked if we ever decided our margin position with Carr.	Ellen: Did we ever determine our margin position with Carr?
I was wondering if you could handle these deals with swap group assistance, please let me know at any time.	Angela: Will you be available? I was hoping that you can handle these deals with swap group assistance. Please feel free to call upon me at any time. Thanks. Sara
I will check with a lawyer from the physical power group to see if we can preserve setoff with respect to ENA's affiliates.	Tracy: Let me know what you think. I'll check with a lawyer from the physical power group. Also, we should at a minimum, preserve setoff with respect to ENA's affiliates. Sara
Thank you for arranging the meetings, I would like to attend along with you and Lynn Aven.	Patricia: Thanks for putting the meetings together. In addition to Lynn Aven and me, both Andrea Calo and Brent Hendry would like to attend. I'm looking forward to visiting with you next week. Regards. Sara
Sara, will you please reach out to Treasury via Lynn's email?	Laurel: Will you please contact Treasury per Lynn's email below? Thanks. Sara
Follow up from a friend of mine in the same field.	Follow up from Brent -
It is necessary to return to Chris.	need to markup and return to Chris
I will not be able to conference on Jan. 11. I have no news to report except that we are working on Argentina financial trading guidelines.	I will be unable to conference on Jan.11. I have no news to report other than we are finalizing Argentina financial trading guidelines. Sara
Please review these pages for any errors and we can make FedEx to Pacific Gas and Electric.	Tana: Please review these pages for corrections and insert into original. Rod should return tomorrow and we can execute and FedEx to PG&E. Thanks. Sara
Is it possible that you've ever heard back from Liz Fernandez or Desiree Monroe?	Have you ever heard back from Liz Fernandez or Desiree Monroe?
Sara: I received it per my ovice mail.	Jay: Per my ovice mail. Sara
Sara, can we meet in the morning to get a status update?	Can we meet in the morning for a status update? Sara
The second email was from Sara.	2nd email. Sara
Suzanne Adams said that it works for her.	works fine for me. Suzanne Adams 09/02/99 09:42 AM
I would add the ongoing cash issue in Canada, as well as run a spell check.	I would only add the ongoing cash collateral issue in Canada (and run spell check).
Sara has your copy, I need to review with you.	Susan: I need to review with Brant but here's your copy. Sara
Please call me if you haven't heard from me yet, I'd love to hear from you, if you haven't already.	Beth Ann: Here's UBS's "redraft" which also requires review. Please call me in a few hours if I haven't contacted you. Thanks. Sara
It sounds good to have flowers and lunch.	Flowers and lunch sounds good. SS Shari Stack 04/10/2000 06:33 PM
We have capacity in Lotus Notes for confirm comments, and I just wanted to make sure this was handled.	I just wanted to make sure this was handled. Also, we have capacity in Lotus Notes for confirm comments. Brent Hendry@ENRON 07/21/2000 01:47 PM
Please let me know if this works by midday, I am able to coordinate with Susan F.	This is short notice but let me know by midday if this works. I can coordinate with Susan F. Thanks. Sara
At this time, we do not have an answer for you.	We do not have the answer for you at this time. It must be researched. Sara Enron North America Corp.
This is the format of the exhibit that will allow you to change the payment account from a credit card to a bank account.	This is the "format" for the exhibit to change payment accounts from the CP to the bank
Lynn, do you have any questions about Trader Guidelines for Argentina, or if I can help you further, please let me know?	Lynn: Weren't you going to take a look at the Trader Guidelines for Argentina? Let me know if you have any questions or if I can help you further. Thanks. SS
Please add your own activities and feel free to edit the sample.	Attached is a sample "format" for summarizing swap group activity. Please add your own activities and feel free to edit the sample. Suggestions are welcome. I'll edit responses in time for our meeting next week. Thanks. Sara
Thanks for revising - please do it again.	please revise - thanks.
I left voice mails for both of them, but I haven't heard back.	Chris: I left voice mails for both Tracy Ngo and Tanya Rohauer about Delano. I've had no response. SS
Sara, please give me a call, I need to send a letter tailored to the contract and situation.	A lawyer should send a termination letter which must be tailored to the specific contract and situation. Give me a call. Sara
We decided that it would not be a good idea to hire outside counsel at the moment since commercial is not pushing.	Mary: We deleted this counterparty from the legal/credit list yesterday. Since commercial is not pushing, we determined that it would be imprudent to hire outside counsel at this time. Sara
I need to verify this one before I meet Mark.	Would like to verify this one before I meet with Mark at 11 am. Sara
Kaye: I think I returned it to you a couple of weeks ago.	Kaye: I think I returned this to you several weeks ago. SS
Sara, I wanted to know if anyone worked on the Destec transaction.	Did anyone work on the Destec transaction? Sara
Jeff was not happy with the foul up by the CSFB.	Jeff: fyi the CSFB foul up
Sara: What's going on here?	John: What's happening here? Sara
Kaye, please print the message and documents.	Kaye: Please print this message and documents. SS
Mike Fowler told me that the entity is "Enron Credit.com limited" but I'm not sure if it's true.	Sheila: Mike Fowler is involved in this effort. He tells me that the entity is "EnronCredit.com Limited". Is this info correct? Sara Sheila Glover 08/11/2000 10:44 AM
It looks like the trade will be done by EAF.	FYI only. It looks like this trade will be done by EAF.
We should redraft a new master if there was ever any P&G comments in the previous one.	Susan: I need to see if we ever incorporated any P&G comments into any prior draft. Then we should redraft a new master (but let's speak with Ed first). Thanks. Sara
Please revise as soon as possible.	Please revise now. Thanks. SS
10:00 AM is a time when the Enron phone number can be found on the left side of the screen.	713/646-3490 Jorge A Garcia@ENRON 10/23/2000 08:30 AM
I don't know who Sue Kelly is, you may want to handle that for the London lawyers.	Tana: I don't know who Sue Kelly is so you may want to handle that end. The London lawyers don't need anything further. Thanks. Sara
Thanks for your assistance, I have attached the short letter that I approved to explain the situation.	Per my voice mail, attached is the short letter I originally approved to explain the situation. Thanks for your help. Sara
When will I be able to see you, what will you do in Miami, and when will you eat sushi?	When do I get to see you? What are you doing for the fourth? When are you going to visit Miami? When do you want to eat sushi? SS
Pat, I would like to speak with you later on today to ask you if you would please give Marie a call so that she can update Lotus Notes.	Pat: Would you please give Marie a call so that she can update Lotus Notes? I'll be talking with Brent later today. Thanks. SS
Do you follow up on this? Tana will give you the file.	Have you followed up on this? Tana will bring you the file. Please ask me any questions. Sara
Sara and Marie will handle it.	Sheila: Thanks. Marie and I will handle. Sara
Mary Cook said thank you and gave a date of 11/17/2000 08:29 AM.	THANKS!!!!!!!!!!!!!!! Mary Cook 11/17/2000 08:29 AM
Below is a reading list for an adventure you are interested in learning more about.	adventure reading below
Call - X 3620, it is called by the name ofJennifer Shipos.	Please call - X35620 Jennifer Shipos 08/22/2000 01:48 PM
Do I need to place these in the database since Carol told me that they have some memos relating to the validity of local derivatives trading in Mexico?	Hi, Shari: Carol told me that you and Peggy have some memoranda addressing the validity of local derivatives trading in Mexico. I would appreciate copies. Do I need to also place these in our legal opinion database? Thanks. Sara
No, not yet Susan Bailey.	no, not yet Susan Bailey 12/20/99 08:29 AM
It seems that our counterparty didn't have the authority to transact.	Looks like our counterparty did not have authority to transact. SS
I don't have any knowledge of this.	I don't know anything about this. Sara Tana Jones 08/01/2000 01:14 PM
I left a message for Bill, and here's my email.	Susan, here's my email. I just left Bill another message. Sara
We will call you early next week after you've received your lease information.	We received your lease information yesterday afternoon and will call early next week. Sara "Tambra Raush" <Tambra.Rausch@conpapers.com> on 01/07/2000 02:29:29 PM
If you haven't seen the execution copies of the documents, please get in touch with Susan Flynn.	Michael and Deepak: Attached are the execution copies of the documents signed with ENA. If I have missed anything, please contact Susan Flynn (as Marie Heard is now with EBS). Thanks. Sara
I assume you have jury duty and you should call when you have a chance.	Sarah: FYI re: FIMAT Canada Inc. I assume you have jury duty. Call when you have a chance. Sara
I must leave the office by 5 pm.	I will need to leave the office at approximately 5 pm. Sara
I don't want to have a conflict with you, so please let me know if you can do 10 am before or after work.	Can't do 10 am! Before or after works. Let me know so I don't schedule a conflict with your preferance. SS Lucy Ortiz 09/07/99 03:48 PM
Sara left a message for Alex but didn't hear back.	Left a message earlier for Alex and have not heard back. Sara
Kim Theriot is probably able to locate these.	Kim Theriot can probably locate these confirms
The BuySideDirect agreement needs to be added to Lotus Notes.	This agreement needs to be added to Lotus Notes. It is required under the BuySideDirect agreement which is under simultaneous negotiation. Sara
Check with either of them to see if she's back.	Left you a voice mail. Check with Stacy or Jeff. Is Janice back?
Please give suggestions, comments, and feedback on the draft report that was attached to begin Friday's discussion.	Attached is a draft report to initiate Friday's discussion. Please provide comments, suggestions, etc. Thanks. Sara
Julia would like to send a copy of the clean and redline version to the other person.	Julia: Attached are the clean and redline versions, respectively. Please execute ASAP and send executed copy to Kristina. Thanks. Sara
You may send a draft on peak confirm to Delano.	Attached is a draft SP 15 on peak confirm which you may send to Delano. SS
If you're available, you can have lunch and a meeting on Thursday, Sept. 23.	Thursday, Sept. 23: lunch and meeting if you're available.
Please read the attached version again because it incorporates most of the comments of the other person.	Attached is a clean version which incorporates most of Brent's comments. Please read again. Sara
Susan Flynn hasn't yet.	not yet Susan Flynn 05/15/2000 08:39 AM
Julia, can I please have a copy of the executed swap confirm? Sara, thank you for all of your help.	Julia: Could I please have a copy of the executed swap confirm? Thanks (especially for all of your help). Sara
Lauren will be in Houston today and will provide us with necessary documentation for opening the account.	Lauren Hagerty is in Houston today and will provide us with the necessary documentation for opening of the account. We will advise when the information is received. Thanks. Sara
That's right.	FYI
The Kevin was going to make a waiver letter, but I gave him the OK.	I gave the Kevin the OK and he was going to prepare a waiver letter. Our conversation was some time ago. Sara Carol St Clair 03/20/2000 08:53 AM
Sara, what's going on with this guy?	WHAT IS THIS ALL ABOUT? HAVE YOU SPOKEN WITH THIS GUY? Sara
I don't need to waste your time leaving me a voice mail and an email.	I have not forgotten. No need to waste your time leaving me both a voice mail and an email. Thanks. Sara Jorge A Garcia@ENRON 11/27/2000 08:57 AM
I will be gone for a while on Friday, June 30.	I will be on vacation on Friday, June 30. Sara
Marie is looking at the latest update from Pat Cini.	Marie is checking with Pat Cini for latest update. We sent this master on 6/23/99. Also, looks like Pat told you about Empresa. SS
I would appreciate it if you would let me know if you think this works for Canada.	Please let me know if you think that this works for Canada. Sara
We just checked with Corp, will you let Warren know when it's over?	We just checked with Corp. It may be later this evening but probably first thing in the morning. Will you let Warren know? Thanks. Sara
I think it's a great idea, Sara Kaye Ellis.	Sounds like a great idea to me! Sara Kaye Ellis 10/21/99 04:55 PM
July 23, 1999 should be the trade date.	The Trade Date should be July 23, 1999.
Sara, I forgot to ask if anyone else is going and if I should make reservations.	Sorry, but I forgot to ask if I should make reservations and if anyone else is going. Thanks. Sara
Can you help please, we don't have access to the financial trading base.	Tana: Jason still does not have access to the Financial Trading dababase. Can you facilitate please? thanks. Sara
Please send credit data to Susan Bailey, we'd appreciate it.	Please send credit worksheet to Susan Bailey. SS Enron Capital & Trade Resources Corp.
The delivery of the IRS Form 1001 is called for in the schedule.	The ISDA Schedule calls for the delivery of IRS Form 1001.
It appears that Paul opened my original memo a day late, it was Susan who said it was another name to deal with.	Susan: Yet another name to deal with! It appears that Paul opened my original memo a day late. Sara
It is important that the following list reflect the old ECT master and no master counterparties by volume.	FYI - the following list reflects old ECT master and no master counterparties by volume (not necessarily exposure). Sara Tanya: do you want all of these names on the legal/credit list?
You'll be able to handle it?	You'll handle?
I'll call you shortly, it looks like the 2-day L/C issue is an issue.	see below. It looks like the 2-day L/C issue is an issue. I'll call you shortly.
Yes, Tracy Ngo on Febuary 2, 2000 at 03:55 PM.	Absolutely! Tracy Ngo 02/02/2000 03:55 PM
It's only information that's important.	FYI only
Sara: How are you feeling about the comments, per Bill's voice mail?	Bill: How do you feel about the comments, per my voice mail. Sara
I just received this in Brazil.	Just received this on Brazil (financial)
Kevin Zemp will e-mail the docs to me after talking to me this morning, I'll keep you posted.	I spoke with Kevin Zemp this morning and he will e-mail docs to me for review. I'll keep you posted. Sara
John is the only authorized trader for the account.	John is the ONLY authorized trader for the Morgan account. SS
New transaction, contacts, etc. need to be entered.	need to enter new transaction, contacts, etc.
That's correct.	FYI
Is Randy a fan of a particular format?	Does Randy prefer a particular format? Sara Elizabeth Serralheiro@ENRON_DEVELOPMENT 10/25/99 06:19 AM
I'll let you know when I hear from you.	Thanks. I'll wait to hear from you. Sara
Sara got a copy of the deal ticket.	Received copy of deal ticket. What's going on? Sara
Thank you for your kind words, Sara Shackleton, of Enron Wholesale Services 1400 Smith Street, Houston, TX 77002 Phone: (713) 853-5620 Fax: (713) 646-3490	thanks Sara Shackleton Enron Wholesale Services 1400 Smith Street, EB3801a Houston, TX 77002 Ph: (713) 853-5620 Fax: (713) 646-3490
Changes to Fixed Price and Additional Provisions are some of the major changes that have been made.	major changes to Fixed Price and Additional Provisions
Sara Shackleton is the owner of Enron Wholesale Services which is located at 1400 Smith Street in Houston, Texas.	Sara Shackleton Enron Wholesale Services 1400 Smith Street, EB3801a Houston, TX 77002 Ph: (713) 853-5620 Fax: (713) 646-3490
Telephone: (713) 853-5620, fax: (713) 646-3490, and email:sarashackleton Enron Wholesale Services is located at 1400 Smith Street in Houston, Texas.	Sara Shackleton Enron Wholesale Services 1400 Smith Street, EB3801a Houston, TX 77002 Ph: (713) 853-5620 Fax: (713) 646-3490
GT&C is needed to make this happen.	check voice mail message. need GT&C to make this go. ss
Mark, can you let me know what you want to do with this?	Mark: Can you reassign this? Thanks. SS
The drafts were sent to ABN AMRO Incorporated in January of 2000 and I apologize for the delay.	Attached are copies of the drafts sent to ABN AMRO Incorporated in January, 2000. I have been out of town and apologize for the delay. Sara
Taffy is fine with me.	looks fine with me Taffy Milligan 02/22/2000 03:53 PM
Is it possible that you have access to the Dow Jones Interactive news service? We just added it in Houston.	Thanks for the faxed info. Do you have access to the Dow Jones Interactive news service? We just recently added it in Houston. SS
I was expecting you to find it.	I thought you'd find it.
Mark: The location for Tuesday, March 19 is not yet known.	Mark: Great! Tuesday, March 19, at 2 pm, location TBD in ECS. Sara
I'm going to Sao Paolo this week. You haven't sent me a mailing address.	I'll be in Sao Paulo this week. You still didn't send me a mailing address. SS SamChawk@aol.com on 11/20/99 09:57:37 AM
We'll meet at 2 pm on Friday to call, can you come up to my office?	Paul: We'll meet Friday at 2 pm to call Jason. Can you come up to my office? Sara Paul Radous@ENRON 11/01/2000 05:37 PM
It should be enough time for me to leave the office.	I have to leave the office by 10:45 am. That should be enough time. SS Suzanne Adams 04/26/2000 02:03 PM
I'm going to review the guaranty after lunch. Have we sent our comments back?	I'll review the guaranty after lunch. Have we sent our comments back? Lisa just did a 5-year deal with Xerox!!!!!!!!! ss
Sara: I would appreciate it if you forwards the executed confirmations for your ENA/Bear derivatives transaction.	Gil: Please forward copies of the executed confirms for your ENA/Bear derivatives transaction. Thanks. Sara
Here it is.	here it is
I received a phone call from Gary asking when he could get the draft documentation.	All: I received a phone call from Gary Ordway asking when he could receive draft documentation. Has anyone prepared credit? Thanks. Sara
I'm not sure what this deal is from.	Paul: What is this deal from Russell Dyke? I'm baffled. Sara
Please let me know if you ever received this hand.	Please let me know if you never received. I had this hand delivered to you on Friday. ss
I would like to join.	I want to join. Enron Capital & Trade Resources Corp.
Sara, I want the futures agreement to be in the "futures agreement" section of the database.	Sam: Please move the CSFB Futures Agreement to the "Futures Agreement" section of the database. Thanks. Sara
I would appreciate if you would send me a copy of the metals confirm and the final format that ENA agreed to.	Mary: Would you please send me a copy of the metals confirm and the final format to which ENA agreed? Thanks. Sara
That's correct.	FYI
The meeting was not called by me.	I didn't call the meeting.
I'm not impressed.	I'm not impressed. Sara Carol St Clair 04/26/2000 12:08 PM
Jeff: We will send it to you if you want it. Rod: Will you get credit for it?	Jeff: We will send the ISDA unless you prefer otherwise. Rod: Will you prepare credit? Sara Jeff Nogid 08/10/99 02:11 PM
Only ACCESS trading has to do with this.	fyi only - this has to do with ACCESS trading only
It's not a big deal, it's just that it's fyi.	fyi
I got a message that said the deal was in a holding pattern.	I just received a message that the deal is in a "holding" pattern Melissa Ann Murphy 09/26/2000 11:55 AM
Sara, I would like to have a delivery schedule, but I have not received it yet.	I would prefer to attach a "delivery schedule" and should have details shortly. Thanks. Sara
Did you hear about Pacific Corp yesterday? Portland wants the draft to proceed with the monetization of the project.	Did you receive my voice mail yesterday about Pacific Corp? Portland wants draft ISDA to proceed with monetization for this project. SS
Michael is a paper trader and he would like to receive SITA updates at least weekly.	Michael and Deepak: Michael Moulton (the ENA paper and pulp trader) is extremely interested in SITA updates as often as possible. Please make every effort to email Michael with updates at least weekly. Thanks. Sara
Susan has some more TVA information.	Susan: Here's some more TVA information. sara
I'm wondering if the legal has received a credit sheet on this person.	Has legal received a credit worksheet on this counterparty? Please give me= a=20 call (or John!). Thanks. SS
Peter is going to check with Sara.	Peter: check with Shari Stack. Sara
It's a Top Ten, we need to follow up, and you should decide who should be assigned to this counterparty and add to Lotus Notes.	Please decide who should be assigned to this counterparty and add to Lotus Notes. It's a Top Ten and we need to follow up. Thanks. Sara
Suzanne probably already reserved a room, that's what I heard from my voice mail.	Per my voice mail. I think Suzanne already reserved a room.
David left a message for Deb to get the scoop on the issues.	David: I left Debbie a message to get the scoop (netting issues with CP, etc.). Sara
Can I call him and let him know that the confirm was sent to APEA when he was a lawyer?	He is a lawyer for APEA. Can I call him and let him know that the confirm was sent to APEA? When was it sent? Sara Diane Anderson@ENRON 11/27/2000 08:16 AM
Thank you very much, please respond.	Please respond. Thanks. SS
The "cherry-picking" short letter needs to be sent as well.	We also need to send the "cherry-picking" short letter.
Sara, please let me know if you will be available for the conference call on Friday to discuss Commerzbank and Morgan Stanley Cap Services.	Paul: Please let me know if you can be available for a conference call with Jason on Friday to discuss Commerzbank and Morgan Stanley Cap Services. Thanks. Sara
If they need commercial help to get the guaranty, they need to talk to either Carol or Tana.	Tanya: Please talk to either Carol or Tana. Maybe they need commercial help to get the guaranty. SS Tanya Rohauer 05/31/2000 08:52 AM
That's right.	FYI
The question is posed by Bernice Rodriguez: What is Merrill?	What is Merrill? Bernice Rodriguez 05/21/99 02:34 PM
Please write on the paper what you want to say.	Please print.
If you want to open this account, please forward your email requests to the RAC group.	Please forward your email requests to the RAC group for opening this account. Thanks. Sara
Please tell me if I have any problems before I take off on Monday and Tuesday.	I will take off the Monday and Tuesday PRIOR to Thanksgiving. Please advise if any problems. Sara
Will you follow up with him? I enjoyed your talk.	Will you follow up with this guy? Great seminar. I enjoyed your talk. SS
Sara, Did you ever give a recap of our Tuesday meeting to legal and credit?	Taffy: Did you ever deliver a recap of our Tuesday meeting to legal and credit? Sara
Thanks, Sara, Exelon is fine.	Stephanie: Exelon is fine as is. Thanks. Sara
I was prompted by Lotus Notes to ask if there was more than one "Marie Heard", but I am not sure if this is true or not.	Guess what? Lotus Notes prompted me that there was more than one "Marie Heard"! Could this be true or do I have a virus? SS
Susan, please hold for the EWEB redraft.	Susan: Please hold for EWEB redraft. SS
Mark, you never assigned this one, and we need to upgrade/select existing master after Chase merged with JP Morgan.	Mark: You never assigned this one. Attached is the EOL list. Chase merged with JP Morgan and we need to upgrade/select existing master.
We will need to update this ISDA on our new format. I'll have to figure out who to send it to.	We will need to update this ISDA on our new, revised, fantastic format!!! I'll have to find out who to send it to. SS
Sara, do you have Jeff's address?	Stewart: Do you have Jeff Fuller's address? Sara
Please reassign this file so I can discuss it with the paralegal who will be responsible for bringing the file to my office.	Please reassign this file this morning and ask the responsible paralegal to bring the file in my office to discuss. Thanks. Sara
Refer to names below if you want to know why Joe Hunter isn't handling financial power anymore.	Joe Hunter no longer handles financial power. Please refer to names below. Thanks. Sara
I have not sent it yet.	I haven't sent it yet.
Edmund, do you know who the Morgan entity you are referring to is?	Edmund: could you please identify the Morgan entity you are referencing? Sara
You are a great employee of Enron North America Corp.	you are too good Enron North America Corp.
You lucky dog, Kaye Ellis.	You lucky dog!!!!!!!!!!!! Kaye Ellis 11/09/2000 09:25 AM
Susan: use the lawyer's guaranty instead of the earlier version.	Susan: this guaranty came from the lawyer. Use this instead of the earlier version. SS
I left a message for Chris Littlefield, but didn't hear back.	I left a message yesterday for Chris Littlefield to schedule call. I have not heard back. SS
This is correct.	FYI
I apologize for missing you yesterday, but can we talk after 3 pm Houston time today? just let me know.	Chris: Sorry I missed you yesterday. Can we talk after 3 pm Houston time today? Just let me know. Thanks. Sara
No.	no
Please forward my report from last week and the target date of Argentina's report to this Friday.	Can you please forward my report from last week and update the "week". Also, change target date of Argentina report to this Friday. Thanks. Sara
That's correct.	FYI
Can't promise that it's going to be 8:30 on the dot, how about 8:45 to 9:00?	Can't promise 8:30 on the dot so how about 8:45 to 9:00?
Sara, could you please follow up on the status of this case?	Could someone please follow up on the status of this CP. Thanks. Sara
Do you want to forward the Master Log to Elena?	Can you please forward the Master Log to Elena? Thanks.
I'd like to let you know that Deutsche Bank is third on the list.	Further to my earlier message, Deutsche Bank is third on the list. Thanks. Sara
Kaye, can you provide me with a list of the documents in my folders so that I don't have to look at them over and over again?	Kaye: Can you print a list of the documents in my folders so that I can eliminate old items? Also, am I still subject to the "backup" of documents?
I have appointments with my doctors from 10:30 am to 3 pm on Friday.	I have doctors' appointments from 10:30 am - 3 pm on Friday.
Sara, I'd like to hear from you, I've had a chance to consider our comments.	David: Have you had a chance to consider our comments? I look forward to hearing from you. Thanks. Sara
At the moment, it's not possible to keep a list of these requests.	At the moment, no. Can you keep a list of these requests?
Clint Freeland and I would like to coordinate the execution of the blackline with the comments from Enron Corp.	Attached is a blackline containing Enron Corp. comments to your latest draft. Please contact Clint Freeland and me to coordinate execution. Thanks. Sara
Sara, are we able to schedule a conference call?	Can we schedule a conference call? Sara
I don't know.	fyi
In the event that Global Finance goes down, I'm forwarding the project in this email and a follow-up email.	Mark: In case Global Finance is desparate in the next two days, I'm forwarding the project in this email and a following email. Thanks. Sara
Is that what it is?	fyi
I think it's very important.	FYI
I need to fax your comments because I don't have an electronic version of the futures agreement.	Sheila: Can you please forward Rob Manders' fax number? I don't have an electronic version of the futures agreement to mark so I will need to fax comments. Thanks. Sara
I understand that an EES asset is going into an asset trust for Hawaii 125-0 and that ENE wants a back-to-back swap with EES.	Deborah: I understand that an EES asset is going into an asset trust for Hawaii 125-0 and that ENE wants a back-to-back swap with EES. Is EES the swap counterparty? Sara
Kaye Ellis said that she guessed right.	Gosh, I guessed right!!!! Kaye Ellis 04/18/2000 01:51 PM
Sara was in charge of this last go round.	Tracy: Tanya handled this last go round. Sara
Please check the assignment language Par 12 (C),(G) for accuracy.	Please review assignment language Par 12 (C),(G) for accuracy.
My crazy sister sent me a message.	A message from my crazy sister!
Dale Neuner on 08/12/99 was fine.	Fine! Dale Neuner on 08/12/99 10:03:32 AM
Sara Mary Cook, can we meet early tomorrow morning?	Hey, Mary! Can we meet early tomorrow morning? Sara Mary Cook 09/11/2000 04:01 PM
Who is going to be helping me with this confirmation?	Who will be helping me with this confirmation?
Please add TGS to this list so that I can review it on Monday.	We can add TGS to this list and remind me on Monday to review. Thanks. Sara
Sara is going to her doctor's appointment on Wednesday.	I have a 9 am doctor's appointment on Wednesday. Sara
Please let me know if anyone can help on Monday.	I'll need help finalizing this (Flynn) Master. Just let me know who can help on Monday. Sara
Sara, can we meet in my office or a conference room?	Yes, shall we meet in my office? or a conference room? Sara
Sara: you should be in charge of this.	Brent: you should be taking this over. Sara
I don't know what's going on, I don't know if it's "ENOVATE" or not.	Kay: What is this all about? I don't know anything about "ENOVATE" . Is it an Enron company? Sara.
Here they are.	Here they are.
I'll be out of the office tomorrow. Please call me if you need me to be out of the office.	I will be out of the office tomorrow. Please have the call if you think it necessary. Thanks. Sara
I don't know anything.	I know nothing. SS
Please make sure you print all of it.	please print all
It's something that I'm aware of.	FYI
We will review and comment on this proposed schedule, since EWEB did not send a CSA.	FYI - this is the proposed Schedule which we will review and comment; EWEB did not send a CSA. Sara
We are going to send you another draft confirmation for the commodity spread swaption.	I am forwarding to you several e-mails received today regarding this transaction. We are going to send out another draft confirmation for this commodity spread swaption. Sara
Please ask Tracy if Ed Sacks should be included in the discussion of financial power trading counterparties.	Tracy Ngo, Melissa Murphy, Kim Theriot, me to discuss financial power trading counterparties. Please ask Tracy if Ed Sacks or anyone else from credit should be included.
Sara, I need your fax number so that I can send you the list of Final and Proposed Regulations.	Hello! Please send me your fax number. I have a list of "Final and Proposed Regulations" which needs to be updated. I would like to fax you the list. Thanks. Sara
Thank you Sara, please print for Mr. McKeogh.	Patricia: Please print for Mr. McKeogh. Thanks. Sara
Sara, I'll talk to you in a while, because we'll redline EWEB's document.	FYI - I'll talk to you in a little while because we"ll redline EWEB's document. Sara
Mark, I was delighted to hear that you have been promoted. I look forward to visiting if I ever get the chance.	Mark: Congratulations! I was delighted to hear of your promotion. I look forward to visiting if I ever make it over to London. Sara
Stuart wanted to make you aware of the reason for the hold up, and that we were trying to resolve it as quickly as possible.	Stuart: I wanted you to be aware of the REASON for the holdup on your FX online product. We are trying to resolve this issue as quickly as possible. Sara
There is a two-year deal that has been booked in mid-November, but we don't know why it is on hold.	Susan: Why is the RMT/NNG on hold? A two-year deal was booked in mid-November and we'd like to confirm under a master. Thanks. Sara
I need to see the " swap" documents asap.	Please print out the "swap" documents for me ASAP. Thanks. Sara
Please send us Harvard's form of guaranty as we continue to explore the issues we talked about yesterday. I will be out of the office next week.	As both parties continue to explore the issues which we discussed yesterday, would you like to send us Harvard's form of guaranty? I will be out of the office next week. Thanks. Sara
Sara, could you please forward your list of assignments to Don, with a copy to me as well?	Alan: Could you please forward your list of assignments to Don (with a copy to me as well)? Thanks. Sara
If I am late for work, I'll call you today or tomorrow.	If I finish my 9 am early, I'll call you. In any event, I'll find a way for us to hook up today or tomorrow. Sara Angela Davis@ENRON 10/30/2000 06:56 AM
Sara, are you still there?	are you still there? Sara
Attached is a picture of the see attached.	see attached
Sara, what do you think about Pat's response?	Christian: What do you think about Pat's response? Sara
Do you recall that we created a response or amendment format?	Don't you recall that we created a response or amendment format? What am I recalling? SS Lucy Ortiz 10/21/99 03:08 PM
Sara, please call, I have a voice mail.	John: Per my voice mail. Please call. Sara
Please call me early today, because you never responded to my question about reference market makers.	Holli: Will you be on this call? Also, you never answered my question about reference market makers. Please call me early today. Thanks. Sara
I'm not sure why you never received this message.	I don't know why you never received this message!
Is Tina right?	FYI - is Tina right?
The "Jana Morse agency" agreement is being worked on.	Who is working on the "Jana Morse agency" agreement? SS
We will need to meet to begin working on this account.	This is the account we can begin working on now. We need to meet (maybe you can drop by). Sara
That's correct.	FYI
Mark, do you want to discuss the ISDA with the Bank of Montreal?	Mark: Do you want to speak with the Bank of Montreal about an ISDA with Japan? Darren has been sending calls to me re: ISDA's and brokerage agreements for our Japanese affiliate. Sara
I haven't heard anything about the deal yet, but an outline for the future revision is attached.	I haven't heard anything further about this deal. Attached is a framework for future revision. SS
I'll take a look at the agreement.	FYI. Also, I'll look at the agreement. Sara
I now need to remember that the old will need an amendment to be replaced with the new.	Tana: Here's the background info. Do you want to prepare the ISDA CSA? We will also need an amendment to replace the old with the new. I now need to reread Tanya's message. Sara
No.	no
Susan, please talk to Rod, Is this one ready to go?	Rod: Is this one ready to go? Please talk to Susan. Thanks. Sara
Please make sure you have a copy of the doc.	please print the doc. SS
There is an update on the impact of Argentine tax issues on our trading business in Argentina.	Attached is an updating memorandum addressing the impact of Argentine tax issues on our trading business in Argentina.
The fax number is 646-3490 and it's from my friend, NINA EDWARDS.	My fax is 646-3490 Nina Edmonds 08/29/2000 05:28 AM
She's adorable and she's good to go. Sara Arap@enron.	Sami: Congratulations!!!!!!!! She's adorable. Sara Sami Arap@ENRON 08/17/2000 03:08 PM
If you need to call Chris Foster in Portland, please assign in the morning.	Please assign in the morning for preparation on Friday, Nov. 17. Whoever receives needs to call Chris Foster in Portland to coordinate. Thanks. sara
If you have the short information sheet that you threw together for Enron company requests, it would be helpful when we meet.	Do you have the short information sheet/request that you threw together for Enron company requests for brokerage agreements? This would be helpful when we meet. I am shooting for Friday at 10 am. Thanks. Sara
We will meet you in Houston at 9 am.	We will conference you in at 9 am (Houston). Thanks. Sara Andrea Bertone@ENRON_DEVELOPMENT 10/13/99 05:34 AM
An ENA form of confirmation is attached for a Gas Daily swap.	Attached is an ENA form of confirmation for a Gas Daily swap (documented under an executed ISDA Master Agreement). Sara
It's per my voice mail.	per my voice mail - c me
We'd appreciate it if you forwards us to Elizabeth and me.	Please forward to Elizabeth and me.
It's helpful if you dated the doc with the effective date of the authorizations.	It might be helpful if you dated the doc with the effective date of the authorizations. Sara Veronica Valdez 12/19/2000 03:09 PM
James, please Ignore my earlier email, as I have an email of your own that I will respond to as soon as possible.	James: Please ignore my earlier email. I do have your email of 6/13/00 and will respond as quickly as possible. Thanks. Sara
That's correct.	FYI
The original blackline is here and I'll revise it today so that we can satisfy Cargil.	Here's the original blackline. Leave me a voice mail with the names and I'll revise my latest blackline today so that we can satisfy Cargil. SS
This is weather, please call Scott.	Brent: this is weather! Please call Scott. SS
Susan: I have given it to him.	Susan: I have given this to Jason. SS
I haven't had any changes from last week.	I have no changes from last week. Sara Elizabeth Serralheiro@ENRON_DEVELOPMENT 12/10/99 03:27 PM
I think your language is too vague, you don't want to include existing risk management services.	I read your language and I think its too vague. You don't want to include existing risk management services.
Kaye, would you please let me know when my lunch with Carol will be, otherwise it will be Tuesday or Wednesday?	Kaye: Would you please reschedule my lunch with Carol to sometime next week (not Tuesday or Wednesday). Thanks. Sara
I believe that the reason you should call Ty is that the notice regarding the ISDA is something we do not have.	Will you please call Ty (whatever her name is)? The reason being that their termination notice relates to the ISDA (I believe) which we do not have. Thanks.
I have to print these as well.	and I need to print these also
Sara "Jason" Peters, petj@andrews-kurth.com>, please, yes, please, please, please, please, please, please, please, please, please, please, please, please, please, please, please, please	Yes, please. Sara "JASON PETERS" <PETEJ@andrews-kurth.com> 08/07/2000 08:01 PM
Sara is trying to get a new ISDA with the current form changes.	We need a new ISDA using our current form changes. Sara
Sara, schedule a time for us to talk.	Let's schedule a time to talk. Sara
By the next legal/credit meeting, you were going to follow up with these counterparties.	You were going to follow up with these counterparties by the next legal/credit meeting.
I was never heard from again last week so I wonder if we should continue to send this report monthly.	I never heard back from you last week. Can we continue to send this report monthly? Some addressees have changed. Sara
great! A woman named Melissa Ann Murphy was alive on 12/14/2000.	great! Melissa Ann Murphy 12/14/2000 02:22 PM
We're going to do it at our own expense, but we'd like to work with Glendale's bond counsel.	We are going to do this at our own expense. But we would like to hire Glendale's bond counsel. I don't know the name of Glendale's bond counsel or how to get in touch with them.
I assume it's for ECT Investments Inc., so please reply with your usual message.	Sheila: Please send your usual message on this one. I assume it is for ECT Investments Inc. Thanks. Sara
Susan will review and change the signature block that has been set forth below.	Susan: Please change the signature block as set forth below and I'll review. Also, we'll email to CP. SS
I received a confirm of the crude this morning.	Attached is my markup of the TD crude confirm which I received this morning. Sara
We've been short staffed and swamped, and I haven't forgotten.	I haven't forgotten. We've been short staffed and swamped. Sara John Viverito@ENRON 06/08/2000 03:54 PM
Sara: I'm waiting for a package from Kim to complete my review of all power financial templates.	Melissa: I am waiting for a "package" from Kim Hundle of all power financial templates for a complete review. Sara
Is it possible that you worked on this for Chris?	Melissa: Were you working on this for Chris? SS
Sam, please let me know asap if there is a need for theDeutsche docs to be marked based onSheila's message.	Sam: Please let me know ASAP whether Jason should be marking the Deutsche docs based on Sheila's message!
Taffy Milligan didn't show up 10/25/2000.	no Taffy Milligan 10/25/2000 11:55 AM
Phone: (713) 853-5620, fax: (713) 646-3490, Sara Shackleton is the owner of Enron Wholesale Services.	Sara Shackleton Enron Wholesale Services 1400 Smith Street, EB3801a Houston, TX 77002 Ph: (713) 853-5620 Fax: (713) 646-3490
Please let me know, who did you speak to, and I will follow up.	Jeff: I have not heard a word from credit. Who did you speak with? Please let me know and I will follow up. Thanks. Sara
Attached is a picture of see attached.	see attached
It's true.	FYI
Thanks, Sara Mary Cook.	Done. Thanks. Sara Mary Cook 08/10/2000 03:30 PM
You are correct, this is FYI.	FYI
Tracy, please make sure that you copy the person who will be preparing the confirmation, as well as the other person that will be assisting the paralegal.	Tracy: Please be sure to copy Melissa Murphy because she will be preparing the confirmation. Stephanie Panus will be the assisting paralegal. Thanks. Sara
I will have an allergist appointment at 8 am on Monday.	I have an allergist appointment at 8 am on Monday. I should be in by 9 or shortly thereafter. SS
Sara, I apologize for leaving your names out.	My apologies for leaving your names out! Sara
Please tell me what you think so that Nancy can get in touch with lawyers.	Please let me know what you think so that Nancy can forward to lawyers. ss
Is this something that you are having second thoughts about?	Are you having second thoughts about this?
Bob, please call me.	See attached. Bob: please call me. SS
I would like you to contact them again.	Will you please contact them again. SS Tana Jones 06/14/2000 10:04 AM
I don't have a signed confirm in my files, my notes indicate we last spoke with CSFB on 9/15/00.	My notes reflect that we last spoke with CSFB on 9/15/00. I do not have a revised confirm (much less a signed confirm) in my files. Sara
Susan should have looked at the ss Enron Capital & Trade Resources Corp.	Susan should have already checked with the counterparty. SS Enron Capital & Trade Resources Corp.
The trades were confirmed last week.	Prior trades already confirmed last week. Sorry.
We will need Scott Neal's signature, so you might want to let him know.	I am finalizing the docs and we should coordinate with Julian. You may want to let Scott Neal know that we will need his signature. SS
Hope the food is good, you are most welcome.	You are most welcome. Hope the food is as good as the OTHER get together. SS Suzanne Adams 06/26/2000 03:43 PM
Only Jay can provide an answer to your question.	only Jay can answer your question
Sara Mark Taylor said yes, thanks.	yes, thanks. Sara Mark Taylor 09/11/2000 09:55 AM
Sara, please call if you have any questions, the clean and redline versions are attached.	Attached are the clean and redline versions for the swap. The changes are in the "Valuation Date" section. This is a final edit. Please call if you have any questions. Thanks. Sara
This is the latest draft.	Latest draft.
Sara, thank you for looking over my shoulder.	Thanks for looking over my shoulder! Sara
Taffy and Sara, are you on Mark's schedule today?	Taffy: Are we on Mark's schedule today? Thanks. Sara
We need to know if any of these are yours.	Are any of these yours? What's the status? We need to respond. SS
The draft was sent out because we do not have any internal comments and we don't know anything about ABN's position.	Joel: thanks - everything was sent out as draft as we don't have all internal comments (and we don't even know ABN's position!). Sara Joel Ephross@ENRON 07/07/2000 08:22 PM
Thank you Sara, this is a wonderful story for future generations.	Congratulations! What a great story for future generations. Love, Sara SSher5DUN@aol.com on 02/20/2000 06:08:07 PM
These files are not all mine. Carol's files, Mary's andMark's may have handled one or two of them.	These are not all my files. Some were Carol's, Mary picked up a Yosemite and perhaps Mark handled one or two. Tana Jones 10/16/2000 10:56 AM
I want to speak with Antonio Felix on Thursday, so please let me know if you have any comments.	Attached is my preliminary description of financial products for trading in Brazil. I will speak with Antonio Felix on Thursday. Please let me know if you have comments. Thanks. Sara
We have to have a password in order to get access to the websites of the publications that we receive.	I remembered! Do we have access to the website(s) of the publications which we receive in order to do searches? We must have a password. Thanks. Sara
The redline shows that the email did not reach anyone, and I think we are ready to speak with Merrill.	It seems as though yesterday's email didn't reach anyone. Attached is the redline. With the exception of numbers (cap, price,etc) I think we are ready to speak with Merrill. Sara
We'll have to meet tomorrow to discuss the situation, I'm sorry, but it's not at the top of my list.	It's not at the top of my list. Sorry. We'll have to meet tomorrow to discuss the situation. SS Susan Bailey 03/09/2000 11:04 AM
I will have you review the revised report before I send it out.	Paul: Here's the report which I will resurrect. I'll have you review the revision before we send out. SS
That's correct.	FYI
I need the copy of final Media General. Also, we need to discuss the notice.	please call. I'd like copy of final Media General. Also, we need to discuss the notice. sara
The meeting with Tozzini will be at 2 pm in Sao Paolo, instead of 10 am in Houston.	We have rescheduled the meeting with Tozzini for 2 pm (Sao Paulo) which is 10 am in Houston. Sara
There is only one live trade, I need to review the outstanding omnibus confirm.	I need to review the outstanding omnibus confirm for this paper/pulp counterparty. I believe there is only one live trade. Thanks. SS
The last two drafts confirm for the Royal Bank of Canada/ECC.	Final two draft confirms for RBC/ECC
Please remove Mark Taylor from the distribution list and put my name and email address on it.	Please remove Mark Taylor from the distribution list and insert my name and email address. Thank you.
The "Re" is the deal number and I think it's the first doc.	I think it's the first doc. Check the "Re" for the deal number. Thanks. Sara
I will leave a voice mail for you.	I'll leave you a voice mail. Thanks. sara
As I write this stock is dropping, it's split effective for stockholders as of 7/23/99.	FYI: split effective for stockholders as of 7/23/99; 2 for 1; as I write this stock dropping. Your analysis, Doctor? SS
I have a letter ready to send, so I'm going to check with you on Monday.	check with me on Monday; I have a letter drafted to send to them
I am reviewing it. Jeff H. will reply with a response to "Necessity for Fallback".	I am currently reviewing. Jeff H. will respond re: necessity for Fallback. SS
Susan, let's have a discussion about this today.	Susan: let's discuss this today. SS
Thanks for the explanation Mark, I have a question for you: how much do you negotiate to the contrary under English law?	Mark: Thanks so much for your explanation earlier today. Just one more question, please: is arbitration or litigation the preferance under English law? How often do you negotiate to the contrary? Thanks. Sara
Can you make a copy of the most recent draft and send it to me before Monday so that we can discuss it?	Tana: Can you make a copy of the most recent draft and get on my calendar before Monday so that we can discuss. Thanks. Sara
There were comments sent to Duke and Duke's NY lawyer today. I don't think there will be any issues.	FYI - comments were sent to Duke and Duke's NY lawyer today. I doubt that there will be any issues. SS
Sean made comments.	Sean's comments
Our contact is for Lotus Notes.	Here's the name of our contact for Lotus Notes. SS
The lawyers have requested separate payments for each fund.	Yes, the lawyers have requested separate guaranties for each fund. SS
Jeff proposed that ENA transact directly with Cincinnati Gas & Electric Company, which was the A rated utility.	David: Actually, Jeff and I have eliminated the "agency" issue. Jeff proposed that ENA transact directly with Cincinnati Gas & Electric Company (the A rated utility). Sara
The weather in Houston is similar to Argentina, and the steak dinner at The Palm will take me awhile to return to.	Lynn and I arrived safely in Houston and the weather seems much like Argentina last week. That steak dinner was delicious and it will take me awhile to return to Pappa's or The Palm. Thanks again. Sara
Look for the fonts's size.	check font size
Susan, which Paribas are you talking about?	Susan: Which Paribas are you referring to?
I asked Carol if anyone thought about this last week but I don't know if she thought about it anymore.	Shouldn't someone contact Amoco? I mentioned this to Carol St. Clair last week but I don't know if anyone thought further about it. Sara Enron North America Corp.
Thanks, this is the master that I refer to in my vm.	Tanya: This is the master referred to in my vm. Thanks. Sara
There is a need to know the value of a dispute.	Need to know value of dispute.
That's right.	FYI
Sara, when do you think you should be on the 30th floor?	How about 9:30 on the 30th floor? Sara
The blackline CSFB is compared.	blackline CSFB for comparison
Sara Neel.Lemon@bakerbotts.com will overnight the agreement to you.	Neel: We will overnight the agreement to you. Sara Neel.Lemon@bakerbotts.com 01/02/2001 09:01 AM
We had a meeting.	per our meeting
I'm wondering if I should include all of the names in your February 2000 org chart.	Sheila: We are still working with our developer to open up access to Gary's group (read-only). Should I include all of the names on your February 2000 org chart? Delete some? Add some? Thanks. Sara
Thank you, Larry Joe Hunter 10/16/2000 03:29 PM.	Thanks! Larry Joe Hunter 10/16/2000 03:29 PM
Call me if you need to check this latest draft.	Please check this latest draft and call me at (713) 853-5620. Thanks. Sara Sara
Thanks, Sara, for the offer to send the agreement for multiple confirmations.	Tana: You offered to send the TXU agreement for multiple confirms. Thanks. Sara
Sara, did you have any comments on the bullet points?	Did you have comments on the bullet points? Sara
Please see attached and it's urgent.	Jim: Please see attached. Urgent. Sara
Dale Neuner said that it looks fine to him.	Looks fine to me. SS Dale Neuner on 08/04/99 10:26:35 AM
Mary, Mieco is one of Carol's "Top Tens". Ed Sacks will be calling you soon.	Mary: Mieco is one of Carol's "Top Tens". Would you please take this one? Ed Sacks will be calling you shortly. Thanks. Sara
ENA has a master of the ISDA in multiple branches.	ENA has a multibranch ISDA master with Soc Gen. SS
Do you think it would be beneficial to invite one of the tax lawyers to our weekly meeting to discuss new forms and answer tax questions?	Should we invite one of the tax lawyers to our weekly meeting to discuss new forms and answer any tax questions? ss
The "cap" that was promised was what Tanya's was.	As promised, Tanya's "cap".
I don't know.	fyi
Steve will also prepare a blackline and CC you, just so that you have a copy.	Just so that you have a copy. Also, Steve will prepare a blackline and cc you. SS
Please reply, the test message has been sent.	Test sent message, please reply. Felix.
I don't know if we should be entrenched in this type of activity.	Should we be entrenched in this type of activity? I'm not even sure that we find out about all of ESA's ideas. Sara
The docs should be printed.	pls print docs
I have a question and want to make comments to the form of confirmation. who should I speak to?	I have a question about the ISDA Schedule and several comments to the form of confirmation. To whom should I be speaking? SS
I don't know about you, but I don't think I'm good at it.	fyi
I will keep you posted, but I haven't looked at your other question yet.	I have retained Utah counsel. I'll keep you posted. I haven't looked at your other question yet but I will ! Sara
If you need to receive notices of default, you must verify the fax number for Enron Corp., VP Finance and Treasury.	Please verify fax number for Enron Corp., VP Finance and Treasury (for the purpose of receiving notices of default) 713-646-4016
Carol, you're right, later today?	Sure, later today? Carol St Clair 05/22/2000 10:43 AM
Will you be handling the documentation? Do you have a resolution to open the account?	Gil: Will you be handling the documentation? Does JSB Asset, LLC have an authorized trader list? a resolution to open the account?
I would appreciate if you would let me know if you still work every other day.	Are you still working every other day? Please see my SITA message to Sharon Lewis and let me know the most efficient way of proceeding. Thanks. Sara
Denis has not forwarded the copy of the master agreement I have requested. Perhaps you could convince him to forward the document.	Aaron: I that master agreement. I have requested a copy of that agreement from Denis O'Connell but have not received the copy. Perhaps you could persuade Denis to forward the document. Thanks. Sara
I'm working with our desk to make sure we get the correct confirm. Should I be dealing with him?	I've been working with our desk to create draft confirm which Brent received yesterday. Should I be dealing with Julian? SS
I will put you on this file and I would like you to add Rod Nelson to Lotus Notes.	I'm putting you on this file. Rod Nelson is credit - please add him onto Lotus Notes.
I'll give you a revision of the doc and then I'll need you to print it on ECT's letterhead.	I will give you a revision to this doc and then I will need this printed on ECT letterhead. SS
I think this was done a long time ago.	Marie: Does this sound weird opening the account on Sept. 27? I thought this was done some time ago. SS
Sara, I will send you a FedEX tonight with my seminar enclosures.	I'll send you a FedEX tonight with my seminar enclosures. Thanks. Sara
Dana, please let me know if there's a time for us to talk about the legal issues associated with derivative transactions between ENA and municipal/governmental counterparties.	Dana: What would be a convenient time for us to chat briefly about the legal issues associated with derivative transactions between ENA and municipal/governmental counterparties? Please let me know. Thanks. Sara
Please advise. Is this a financial instrument?	Is this a financial derivative? Please advise. Sara -----Original Appointment-----
I need an explanation of the account's purpose.	Would someone please provide me with an explanation of the purpose of this account. Thanks. Sara
My voice mail is in the form of a phone call.	per my voice mail
Please call if you want an opinion on Section 19(i) of the Accord.	We would like the opinion to address Section 19(i) of the Accord. Please call. Sara Enron Capital & Trade Resources Corp.
I need a firm to answer my derivatives questions, but I have no clue who they are or how to get in touch with them.	Frank: Have you ever hired New Guinea counsel? I need to engage a firm to answer derivatives issues. Thanks. Sara
Thanks for the help yesterday, I would like to know if you can call A&K to make sure that they include Ms. Davis in the distribution.	Good morning! Thanks for your help yesterday. Would you please CALL A&K and make sure that they add Angela Davis to the distribution? Thanks. Sara
It's interesting.	FYI
Sara called and said that Warren had called and wanted us to fax the certificate to him.	Stephanie: Warren Tashnek called and would like us to fax the certificate to him directly. fax 713-629-1933 phone 713-629-1896 Thanks. Sara
Bruce will be out of the office on Monday but Sara wants to talk about what's going on.	Bruce: I'm out of the office tomorrow but will be back Monday. Let's talk then please. Sara
I would like to know if the correct legal entity is "European Power HOLDINGS", and if the correct party is Maroon Aboudy.	Please ADVISE if "European Power Holdings" is the correct legal entity for closing out the FX piece of Sutton Bridge and if Maroon Aboudy is the party to whom a confirm should be directed. Thanks. SS
Sara should prepare the ISDA as per the request.	Please prepare the ISDA as requested. Sara
Mary and Carol are not able to reach me on 12-8, I'm not available on that day.	Carol and Mary: I am not available on 12/8. Sara Carol St Clair 11/16/2000 11:22 AM
Kevin Zemp will be available to assist you through immigration with the appropriate officers after you return from your trip.	When you return from your trip, please follow up with respect to your entry to Canada through Calgary. We are revising your letter and Kevin Zemp will be available to assist you through immigration with the appropriate officers. SS
We need to use that introductory paragraph aboutmutual promises, etc., because the attached form does not have a premium.	attached is the form. no premium. Also, we need to use that introductory paragraph about "mutual promises, etc,"
Bob: I'm sending this to let you know that I'm working on a doc that will be useful to you.	Bob: I'm only sending this message so that you can see all correspondence. This doc will be useful to you.
Susan and Sara, please let me know who will take care of it.	Susan and Susan: Please let me know who will handle. I am holding the confirm. Sara
I need to speak with Russell and let you know how we are going to change the Threshold.	Stephanie: I have put you in charge of this CP (formerly S. Flynn). We are going to have to amend the Coll. Threshold. I need to speak with Russell and will give you details. Thanks. Sara
Sara, let's talk.	Let's talk. Sara
I don't know.	fyi
A few loose ends to tie up after we had a conversation with Pacific Gas and Electric.	Had a conversation with PG&E this afternoon and we're almost finished. Just a few loose ends to tie up. Sara
I'd like to know more about the redraft.	I'd like to the redraft. Sara Stephanie Panus@ENRON 09/05/2000 09:02 AM
I have been at Enron for more than a decade.	You bet! It's me. I've been at Enron since mid-1994. Sara egflegal 08/08/2000 09:33 AM
We need the legal name of the company. Also, does that company already have a plan of action for opening a broker account?	Tom: There is no existing Enron company named "ECT Europe Investments Inc.". We need the legal name of the company. Also, does that company have existing resolutions for opening brokerage accounts?
You can get global contract numbers from financial contracts.	financial contracts are 1-way you can obtain global contract numbers
We need to send an updated form to these guys, but will there be credit changes?	Holly Krebbs just did a deal with these guys (short form) but they want to negotiate an ISDA. We need to send an updated form to them. Will there be any credit changes?
Sara said she was sorry to not reply sooner, and that she tried to keep track of the language.	Sorry to not reply sooner - too many interruptions - see attached (I tried to track language in PB). Sara
Vintage wants ENA to give a guaranty of a transferee's performance under the master.	I received comments from Vintage (remember, no CSA). With respect to Transfer, Vintage wants ENA to provide a guaranty of a transferee Affiliate's performance under the master. Let me know your response, please. Sara
Are these exactly the same as our doc? need to check right away.	Stephanie: Are these identical to our docs? need to check ASAP
I think this is the same as the other one.	I think this is identical. Also print Bali trust
Have you spoken with Marval? I'd really appreciate it if you could give me some more information.	Have you and Mark ever discussed this? Have you spoken with Marval? I'd really like some more information. Thanks. SS P.S. Is tomorrow a holdiay in BA?
I won't be able to make the call tomorrow.	I will not be able to make the call tomorrow. Sara Elizabeth Serralheiro@ENRON_DEVELOPMENT 12/20/99 05:31 AM
If you send John Stoner an email with Kevin Cordesman and Andrew Conner in it, please give me and my business guys a shout out.	The business guys are: Kevin Cordesman and Andrew Conner If you email John Stoner, please cc these guys (and me). Thanks.
Is it possible that you would like to convert this doc?	Would you please convert this doc? SS
That's fine, but I have to head out the door before 5 tomorrow.	That's fine but I have to leave shortly before 5 tomorrow. Sara
I would like to take the days in February as a vacation, but I need to know if there is a conflict.	I would like to take the following days in February as vacation days: February 3,4,18 Please let me know if this presents a conflict. Thanks. Sara
Why are you referring to futures for the equity? I believe the only futures are equity index contracts.	Why are you referring to "futures contracts" for the equities? I thought that the only futures were equity index contracts.
I have to go to my home at 10:30, so please let me know if you need to speak to me.	I have to leave the office at 10:30 to be at my home. I should be back after lunch. If you need to reach me, please feel free to call at (713) 664-3207. Thanks. Sara
Kaye will email the confirm/settlement list, do you want her to handle global contracts?	Kaye will update the confirm/settlement list and send out the email. Do you want her to handle global contracts or will you? Sara
I'll be there on Thursday.	Thursday I'll be there. Greg Johnston 10/03/2000 09:11 AM
This is your file, you were given it by Susan Flynn.	Samantha: this is your file, inherited from Susan Flynn. SS
Sara, thanks for the catch, you've made a big deal out of it!	Thanks for the catch! Sara
There is a new request and it's related to the master tax agreement.	FYI new request. What about our master tax agreement?
Marie is fine with either Friday June 2 or 9.	Marie is fine with either Friday June 2 or 9. So let's pick June 2 unless someone has a conflict. For quick planning (invitations, caterer, limo, etc.), who wants to help? Sara
London told us that they wouldn't trade with ECT International so we assumed credit would have to be London credit.	Credit needs to initiate (and it may have to be London credit) but Tanya Rohauer will know. FYI - London told us that Sempra "will not trade with ECT International." SS
This is the one Marie is looking into, and it seems to have been executed.	Sheila: Marie is looking into this one which appears to have been executed. Sara
I am not sure what to make of it.	fyi
The letter was signed on ECT's letterhead.	letter on ECT letterhead and signed
I don't know what I'm supposed to say.	fyi
I should have signed the papers tomorrow, that is when we're done.	We're done. I should have signed docs tomorrow. Sara Caroline Abramo@ENRON 11/09/2000 10:24 AM
We're still waiting for the bank to give us the go-ahead to swap the commodity swap.	Attached are revised commodity swap confirms. I didn't change the rate swap and we're still waiting for input from the bank.
We should pursue the Morgan Cap Services agreement. Let's talk after you have a chance, I've put this on our legal.credit list.	Susan: Based on Tanya's message, we should pursue the Morgan Cap Services agreement. Let's talk when you have a chance. I've put this on our legal.credit list. SS
You'd better be back in town if you're going to do that!	You'd better be back in town! Sara Yao Apasu@ENRON_DEVELOPMENT 05/30/2000 03:25 PM
That will be fine, that will be fine, that will be fine, this will be fine, this will be fine, this will be fine, this will be fine, this will be fine, this will be fine, this will be fine, this will be fine, this will be	That will be fine. SS Taffy Milligan 04/13/2000 11:28 AM
The package was sent to you on Dec. 19 by the lawyer's direction.	Chris: We emailed the Schedule on Dec. 18. We Fed Exp'd the "package" (except the ENE guaranty which is being executed) on Dec. 19 to the lawyer at your direction. Sara
I don't recall, but I'm pretty sure I sent a message to Tanya before I talked to you.	Brent: I must have been reviewing something from this CP when I sent the message to Tanya. Is Tanya right about having discussed this with you already? I can't remember. Sara
There was a typographical error in your e-mail address.	Had a typo in your e-mail address!
Bill apologizes for the malfunction.	Bill: Sorry for the malfunction!
Is it appropriate for a master net to be here?	Is master netting appropriate here? Sara
Kaye, please schedule Sam for an hour on Friday because people are always late, and also because I would prefer not to meet at 1 pm because people are always late.	Kaye: Please schedule Sam for an hour on Friday. Also, when avoidable, I'd prefer not to meet at 1 pm because people are always late. Thanks. sara
I will fax a copy of the real financial power Transaction that is routine as opposed to a structured deal, if you have any questions.	Attached is a template for an ISDA swap. I will fax a copy of a "real" financial power Transaction (which is routine as opposed to a structured deal!). Call if you have any questions. SS
Please send the transaction to me so I can read it.	Please send me the Transaction referenced in the Termination. Thanks. Sara
Sara, what about the limitation of liability language that you suggested, could it be similar to the PB agreement?	Daniel: What about the limitation of liability language which you suggested could be similar to the PB agreement (your 9/20/01 email)? Sara
Can you get the certif from Deb?	Tana: Can you get certif. from Deb?
Tracy please let us know when you've reached a conclusion.	Tracy: Please let us know when you have reached a conclusion. Thanks. Sara
It's not really a surprise that it's not really a surprise that it's not really a guess as to why it's not really a surprise as to why it's not really a surprise as to why it's not really a surprise as to why it'	fyi
I sent you a request for Gregg, and I wanted to ask if you could send it to him.	Stephanie: I sent you a request last week for Gregg. Could you please send Gregg the boilerplate? Thanks. Sara
It's a good thing.	FYI
Yes, it's true.	yes
I will book you a room up to 60 days in advance.	I'm busy today and tomorrow. But I'll book up to 60 days in advance (like the French Laundry in Napa) for you. SS
John V. was going to sign this.	Marie: here's what John V. was going to sign.
Do you have something to say?	Do you all have comments?
I'm not sure if this will change the definitions contained in our March draft, but I'm pretty sure it will.	I just received this from Stoner. Tanya: I haven't reviewed this agreement, but my guess is that it may change some of the additional definitions contained in our March draft. Sara
I am unable to attend the performance of A Midsummer Night's Dream but I can give you two tickets for free.	I have two (2) tickets to the Friday, Nov. 3 performance of "A Midsummer Night's Dream" which I cannot attend. Let me know if you're interested - they're free. Sara
That's right.	FYI
I forwarded Bruce's message which requested 2 accounts, as well as a request by Enron South America for a new account.	FYI: Enron South America has requested a new account for CIESA deal. I'm also forwarding Bruce's message which requests 2 accounts. Sara
Susan and I are always available. Since our trading meeting is at 11 am, can we be there at 9 am?	Carol: Susan and I are available anytime. How about 9 am (since our trading meeting is at 11 am)? Sara
I was just checking to see if we were going to execute the amendment to the security agreement to allow the rehypothecation of securities.	Phil: I was just checking to see when we would execute the amendment to the Security Agreement (to permit the rehypothecation of securities). Please let me hear from you. Regards, Sara
Holli requested this again in the month of March, so I am wondering if you ever sent a credit worksheet for EWEB.	Have you ever sent a credit worksheet for EWEB? Holli Krebbs requested this again in mid-March. Thanks. Sara
It's only true if you take into account the other factors.	FYI only
Please let me know if I received anything from your NY office for me to sign. I know that you're in London and I was just checking to see if I received something from your NY office for me to sign.	Hi, Thomas! I know that you're in London and I was just checking to see if I was to have received something from your NY office for me to sign. Please let me know. Thanks. Sara
Sara: I need to know when you are going to fax the name change doc.	Sam: Could you please call these guys this morning and offer to fax the name change doc? Please let me know when this is done. This is a HIGH PRIORITY. Thanks. Sara
Lucy: Please send the new draft of the document to me, I need it for my files.	Lucy: Please send me the redraft of this document for my files. Thanks. SS Lucy Ortiz 07/26/99 03:32 PM
Sara, at that point, what do you want to do?	yes, please. At that point, how do you want to execute? Sara
Sounds like a very interesting meeting.	Sounds like an interesting meeting. SS
I don't know if anyone is looking at this.	What is the issue? I have no idea if anyone is looking at this. Sara
Carol, you may want to check with someone on the weather desk because you haven't heard about this deal until this email.	Carol: I haven't heard a peep about this deal until this email. You may want to check with someone on the weather desk. SS
Taffy Milligan was not present on May 23, 2000.	no Taffy Milligan 05/23/2000 02:36 PM
Dale Neuner just didn't have a voice.	ok just no voice. Thanks. Dale Neuner on 10/21/99 01:45:01 PM
I'll be out of town on Feb. 3 and 4. Kaye Ellis knows how to get in touch with me.	I'll be out of the office Feb. 3 & 4. Carol is attending a class on Feb. 3. Please direct inquiries to lawyers present on those two days. Kaye Ellis knows how to reach me in Baton Rouge.
You have a link!	Da link!
Please make sure to print it.	Please print
I spoke to Tracy Ross at the bank this morning.	Tracy Ross at RBC (I spoke with her this morning). SS
The network was so busy that the resend was had toTrademarkiaTrademarkiaTrademarkiaTrademarkiaTrademarkiaTrademarkiaTrademarkiaTrademarkiaTrademarkiaTrademarkiaTrademarkiaTrademarkiaTrademarkiaTrademarkiaTrademarkiaTrademarkiaTrademarkiaTrademarkiaTrademarkiaTrademarkiaTrademarkiaTrademarkiaTrademarkiaTrademarkiaTrademarkiaTrademarkiaTrademarkiaTrademarkiaTrademarkiaTrademarkiaTrademarkiaTrademarkiaTrademarkiaTrademarkiaTrademarkiaTrademarkiaTrademarkiaTrademarkiaTrademarkiaTrademarkiaTrademarkiaTrademarkiaTrademarkiaTrademarkiaTrademarkiaTrademarkiaTrademarkia	had to resend due to overworked network. ss
Sara, I hope this is for you.	I hope this is really for you! Sara
Please call me and I'll talk to you.	Laurel: Please call me and let's talk. SS
Sara, I've never heard back from Jean-Pierre about our comments.	Is FIMAT Canada emailing the form? Sara P.S. I never heard back from Jean-Pierre about our comments
Please advise, if 9 am is convenient for you, you should go to Enron's offices on Tuesday, November 30.	AFAC and Marcelo: Thank you for the message. We would suggest Tuesday, November 30 at Enron's offices. Is 9 am convenient for you? Please advise. Regards. Sara
That's correct.	FYI
2 more confirmments appear to be mixed up between Toronto Dominion and Royal Bank of Canada.	Joe: 2 more confirms (appear to be mixed up between RBC and Toronto Dominion.
It's true.	FYI
John Suttle talked to Jeffrey pak.	John Suttle spoke with Jeffrey Pak. All is fine. Sara
I don't know about you, Tana Jones 1017/2000 01:29 PM.	not me Tana Jones 10/17/2000 01:29 PM
You are invited to come to the office at 1:30 for discussion on the revision of the worksheet.	Tanya will come to my office at 1:30 to discuss revision of the worksheet. Hope you can make it! SS
Thanks a lot.	thanks
If we want to designate specific individuals, we might want to use a "generic" address.	Jason: Before we designate specific individuals, let's think this through. A "generic" address may be more appropriate. Which agreement did we recently sign with reference to the "Documentation Desk"? Sara
The latest draft of the "Daily Call option" confirmation between Merrill Lynch Capital Services, Inc. and EPMI is attached.	Attached is the latest draft of the "Daily Call Option" confirmation between EPMI and Merrill Lynch Capital Services, Inc. This is the same draft that Rodney received on Friday, Dec. 17.
I wanted to inquire about SMUD but after the legal/credit meeting it sounded like a special deal language was going into the schedule as opposed to the confirm for the transaction.	Brent: I wanted to inquire about SMUD. After the legal/credit meeting, it sounded as though special deal language was going into the Schedule as opposed to the confirm for the Transaction. Thanks. Sara
Sara, what is this all about?	ED: what is this all about? Sara
Bryan/Mary said that the check had not been received when she was at the company.	Bryan/Mary: When Sheila left the company, the check had not been received. Laurel is now on ECS, 4th floor, and is checking for receipt of the check. Sara
Susan Flynn said that she'll need the file.	I'll need the file - Susan Flynn 01/19/2000 03:32 PM
You can speak to Tana, she will give you the full explanation.	Please speak with Tana. She will provide you with the full explanation (online/offline). SS Sheetal Patel 07/25/2000 11:57 AM
My voice mail is sent per my voice mail.	per my voice mail
Please send this agreement to all trading lawyers, we need to know what you are up to.	Becky: Could you please email this agreement to all trading lawyers? (Taylor, Hodge Sager, Aronowitz, Tweed groups?) Thanks
Susan, please call our rep at Morgan to get the paperwork signed, we need to set up this account before 5/30.	Susan: We need to set up this account for funding on or before 5/30. Please call our rep at Morgan and let's get the paperwork signed. Sara
I was just not willing to let it slip through the cracks.	I can wait; just didn't want it to slip through the cracks. Thanks. Sara
If you update this document weekly, I'd be better off and you'll get an e-mail from Randy's assistant.	I will have to update this document weekly so I'd feel better if you updated, etc. I'll bring the info shortly and we can e-mail to Randy's assistant in Sao Paulo. Thanks. SS
I'm Taffy, and my last name is "Shackleton".	Taffy - my last name is spelled "Shackleton". Thanks. ss
Is Prime Trade for ENA? Would you send an email to Ted?	Darren: Is Prime Trade for ENA or ECT Investments? Sheila: Would you please send an email to Ted?
Is it possible that I'm nuts?	am I nuts?
Kaye and I will work on a schedule to get me to my home for the repairs today and tomorrow.	I will need to be at my home today and tomorrow at 4 pm for repair estimates. I will coordinate my schedule with Kaye. Sara
I'd like to talk on Monday, October 2, please let me know if you're able to.	Paul: per my voice mail, please let me know if you or Rod will handle. The FX traders are hollering (on both sides of the Atlantic). I'd like to chat on Monday, October 2. Thanks. Sara
Please send the print in a timely manner.	Please print asap. Thanks. ss
Sara, I'll wait to hear from you.	Jay: I'll wait to hear from you. Sara
No way.	No way.
It was discussed as we just did.	As we just discussed. SS
Sara, I would appreciate it if you added me to the distribution list for clippings.	Would you please add me to th distribution list for clippings. Thanks. Sara
This is fine for me.	This if fine for me. SS Taffy Milligan 03/06/2000 04:53 PM
I just sent a fax and did not have anything to attach to it.	I just sent a fax to Chip Rainey. No attachments. Thanks. SS
The office of Sara Shackleton is 1400 Smith Street in Houston, Texas.	Sara Shackleton Enron Wholesale Services 1400 Smith Street, EB3801a Houston, TX 77002 Ph: (713) 853-5620 Fax: (713) 646-3490
Rod Nelson is a director in the debt portfolio group.	Pizzolato (a director in the debt portfolio group) Rod Nelson 08/01/2000 02:18 AM
Mark: Attached is a list of the things he is handling for the group, I'm trying to keep track of it.	Mark: Just in case you're curious, attached is a listing of items Jason is handling for the group. I'm trying to keep track.
I am pretty sure that Annabel said the assignment was fine and that we would execute when we got the Securities Lending Agreement done.	Here it is. I'm fairly certain that Annabel said the assignment was fine and we'd execute when we got the Securities Lending Agreement done. SS
Yes, with an off-shore or offshore counterpart, as it desires.	Yes, offshore (ie, as ENA) with an onshore or offshore counterparty, as it desires. SS
I will get to it today.	Yes, I'll get to it today. I've already spoken with Jared. SS
Gary Hickerson came to talk about equity trading and asked if he could give him a call on Friday.	Can you give me a call on Friday? Gary Hickerson came by to talk about equity trading. SS
My assistant will be making copies for you and me.	My assistant Becky Spencer will have copies made for you both.
Nancy has forwarded this to Cynthia as part of the "Intercompany contracts" review process.	Nancy: I have forwarded this to Cynthia as part of the "intercompany contracts" review process. Sara
The fax number I use is (713) 646-3490).	My fax number is (713) 646-3490. SS
I don't know if the problem has been solved, I have not been notified for the last two pay periods.	I have not received notification for the last two pay periods. Is the problem resolved? Sara Shackleton EXT. 35620
I'll let you know a brief comparison of the ERMS/Merrill ISDA from 1992 with the ENA's typical ISDA used in 1999 by the morning.	I'll send you a brief comparison of the ERMS/Merrill ISDA from 1992 with ENA's typical ISDA used in 1999 by the morning. Am currently working to produce the confirm format. SS
I will meet with you soon to discuss further.	Let's enter into the database. I'll meet with you shortly to discuss further. Thanks. Sara
Sara: Here's another email.	Angela: Here's another email. Sara
Sara Shackleton works for Enron Wholesale Services at 1400 Smith Street in Houston, Texas.	Sara Shackleton Enron Wholesale Services 1400 Smith Street, EB3801a Houston, TX 77002 Ph: (713) 853-5620 Fax: (713) 646-3490
Clement should respond re: the guaranty, because we are following up on the P/A.	Susan: The tax rep is fine. We are following up on the P/A, and Clement should respond re: the guaranty. Sara
I asked him if he had any knowledge of any hedge funds in Texas or California.	I asked him if he knew of any hedge funds in TX or CA.
The question is about online and offline products, to the extent that we gear up for metals online.	Is the question for online and offline products (to the extent that we gear up for metals online)? Noel Petterson@ENRON 07/31/2000 08:05 AM
Please email the RAC group to request the opening of the account.	Please forward your email to the RAC group requesting the opening of this account. Thanks. Sara
I was on the phone. Ignore my prior email.	Sorry, I was on the phone. Financial contracts are all 2-way. Ignore my prior email
Sara, can you please let me know if you or Jean are able to review the confirm for the one of our year-end deals?	David: We are drafting a credit derivative confirmation in connection with one of our year-end deals. Will you or Jean be able to review the confirm with us? I look forward to hearing from you. Regards. Sara
Hey, man, what's going on, have we thought this through?	Hey, man, what's up? Have we thought this through practically?
Sara, I look forward to hearing from you and attaching a redline based on the document generated by you.	Attached is a redline based upon the document generated by you. I'm sure there will be many items for discussion and I look forward to hearing from you. Regards. Sara
I need to review and have executed this agreement but I'm not able to log in on Lotus Notes.	Sam: What happened to this agreement? It's not logged in on Lotus Notes a= nd=20 I need to review and have executed! Please call me. Thanks. Sara
Could you please take care of me while I'm gone?	Brent: Could you please handle in my absence? Laurel I'll be back on Wednesday, Nov. 22. SS
Sara, I'd appreciate if you would print these documents for me.	Kaye: Will you please print these docs for me? Thanks. Sara
The lawyer for Lehman will call me back tonight to give me more information.	I spoke with the Lehman lawyer who will call me back this evening with comments. Rod: Daniel Goldhagen is their credit officer.
The comments are for the confirm, please note that you must reference the KPM transaction in the Additional Provisions section.	Jarrod: attached are comments to the confirm. Please note that you must reference the KPM transaction in the Additional Provisions section, part (iv). Sara
I would like to attend.	I'd like to attend. SS Sheri L Cromwell 10/21/99 09:24 AM
If you're still here, please call me at the office. I'll talk with Richard first thing on Friday.	Please call me at the office (713/853-5620) if you are still around. Otherwise, let's plan to speak with Richard Sanders(litigation) first thing on Friday morning. I have spoken with Julian. Sara
We can't agree on a date for this luncheon until we hold these names.	Please hold these names until we can agree on a date for this luncheon. Thanks. SS
Sara, I'm wondering if you can give me a copy of the recent tolling agreement?	Doug: Per our conversation, will you please forward to me and Sami a copy of the recent tolling agreement? Thanks. Sara
I will have to leave at 5 pm on Thursday and leave again at 4 pm on Friday to be home for the food delivery.	I will have to leave shortly before 5 pm on Thursday. Also, on Friday, I will have to leave around 4 pm to be home for the FOOD delivery!
Let me see if I can get the legal people I need. I will let you know soon.	Let me first see if I can muster up enough legal people. I'll let you know shortly. SS Dale Neuner on 09/05/99 10:02:22 AM
Sorry for not getting back to you sooner, but you don't need to do anything!	Per: You don't need to do a thing! Sorry for not getting back to you sooner. Have a good weekend. Sara
The CFO for EnronCredit.com would like a link to be able to access Lotus Notes.	Tana: Richard Sage, CFO for EnronCredit.com, would like a link to be able to access Lotus Notes. Could you please arrange? Thanks. Sara
Sara, Steve asked you to email theCSA for comment, Susan, after he called again.	Susan: Steve Morus called again and asked that you please email the Schedule/CSA for comment. Thanks. Sara
Sara, we'll call you at 2 pm Houston time.	Brent: We'll call you at 2 pm Houston time. Thanks. Sara
Just let me know, "R. Carson Llewellyn", I'd love to hear it.	Just let me know - "R. Carson Llewellyn" <carlew@flash.net> 07/05/2000 11:43 AM
We are sending the fax to you right now.	we are faxing to you now
There's something to be said.	FYI
I'm checking Canadian legal issues, and I have three Canadian utilities that are almost ready to go.	I have three Canadian utilities almost ready to go; checking Canadian legal issues. Sara
I will try to have Jeff or Clint available for a conversation after I have received the comments from Enron Corp.	Christine: Attached are Enron Corp.'s comments to your form of forward. I'll try to have Jeff and'or Clint available for a conversation. Thanks. Sara
Sara, please attach the attached document for our discussion.	Per our discussion, please see attached. Sara
You will need this format for the masters of Enron Corp.	Here's the format which I understand is being signed. You'll need this for Enron Corp. masters. Sara
Sara needs to leave the office at 5 pm today.	I need to leave the office at 5 pm today. Sara
I need to negotiate early termination after doing a swap with BofA.	Did a swap 2002-2008 term with BofA. Please send confirm to me upon receipt. Need to negotiate early termination. Thanks. SS
Sara, please let me know if this works, because I have attached my blacklined comments to the prior draft.	Andy: Attached are my blacklined comments to the prior draft. Please let me know if this works. Thanks. Sara
Sara, please let me know what you want to do.	Angela: Please let me know how you want to proceed. Thanks. Sara
It's an interesting way of summing up fisticuffs.	fyi
Louise received a call from Jeff Blumenthal, who wanted to be included in the meeting.	Louise: I received a call from Jeff Blumenthal (Houston tax) who would like to be included in the meeting. His availability is Friday only. Thanks. Sara Louise Bird 10/25/2000 02:59 AM
Kaye Ellis was at her office on Thursday, Nov. 16.	Thursday is Nov. 16. Kaye Ellis 11/13/2000 12:00 PM
Mary, please let me know what happens, all calculations should be done as of a specific date.	Mary: Please let me know what happens. All calculations should be made as of a specific date. Sara Mary Cook 08/02/2000 01:12 PM
I would like to buy lunch for you before the millenium.	SUPER congrats!!! Can I buy you lunch before the millenium? SS
Sara Shackleton has a store at 1400 Smith Street in Houston, Texas.	Sara Shackleton Enron Wholesale Services 1400 Smith Street, EB3801a Houston, TX 77002 Ph: (713) 853-5620 Fax: (713) 646-3490
I usually don't forward these messages, but this one is funny.	I normally wouldn't forward these messages but this is funny!
Richard, if you have sent a letter, the first payment should be due in late November 2000 or early December 2000.	Richard: Have you sent a letter? The first payment should be due (for the month of November, 2000, billed in early December, 2000). Sara
I am forwarding a resume to a legal candidate in Argentina who might be interested in ENA.	I am forwarding a resume from an Enron Argentina legal candidate who is perhaps interested in ENA.
It's so far away, that's a very nice thing. It's so far away, that's a very nice thing.	FYI
Rod Nelson told him to speak to Treasa.	Rod: You need to speak with Treasa. Rod Nelson 11/15/2000 12:21 PM
Yes, Dale Neuner on June 16th.	yes Dale Neuner on 06/16/99 02:34:29 PM
The lawyers from Credit Agricole are asking for the ENE guaranty, so thanks for getting my paper over the weekend.	Susan: Thanks for getting my paper over the weekend. I received more comments from the Credit Agricole Indosuez lawyers (outside). They are asking for the ENE guaranty. I have the file in my offic.e SS
For the rest of the information, please send an email to the person named tmbra.	Email Tambra for the remaining information. SS
I'm wondering if you've had an opportunity to review or comment on the CSA.	Happy New Year! Just wondering if you had an opportunity to review the CSA and comment. Drop me a line or call 713/853-5620. Thanks. Sara
Sara, can you give me a call to discuss the situation in regards to Willie's problems, Jeff? I think we should update the situation in regards to Willie's problems.	Jeff: I thought we should update the situation particularly in light of the problems that Willie runs up against. Can you give me a call and let's discuss. Thanks. Sara
Clint has not seen it yet, so we have been talking this morning.	This was received Friday evening. Clint has not seen but we have been discussing this morning. Sara
I will be out of the office on Feb. 3 and 4 so let me know if you're able to rearrange earlier.	FYI - I will be out of the office on Feb. 3 and 4. Let me know if you want to reschedule earlier. Thanks. Sara
I'm not sure what to make of it.	fyi
The foil was foiled again.	Foiled again!!!!!!!!!!!!!!!!!!!!!!!!!!!!!!!!!!!!!!!!!!!!! Yao Apasu@ENRON_DEVELOPMENT 06/06/2000 07:36 PM
If Mark wants me to finalize, please let me know.	Mike means "Mark Taylor". Would you please let me know if Mark wants me to finalize. Thanks. ss
I spoke to Mark and he said the week of August 16 was better for the visit since he was on jury duty.	I spoke with Mark and (after checking one point in the a.m. on jury duty) he thinks that the week of August 16 is preferable for the visit. I will verify this first thing in the morning. SS
It's February 17 and I think it's good for me.	Feb. 17 is good for me.
The account number is correct, so please add a "without duplication" language to the Floating Amount calculation.	The account number in the confirmation is correct. Please add "without duplication" language to the Floating Amount calculation.
Is it possible to handle or should Carol?	Can you handle or should Carol?
I'd like to focus on the dates, but David has an example of "tainted swaption".	David: Attached is an example of the "tainted swaption". I'd really like to focus on the dates (Trade, Effective, Exercise). Looking forward to call in the morning. Sara
Can you talk late this afternoon? Is the trading issue related to the services agreement?	Can you talk late this afternoon? In connection with the "trading issue", have you taken a look at the services agreement ?
Yes, and the template should not be an ISDA one, that's for sure.	yes, and the template should not be an ISDA template
Sara will fax the entire confirmation.	Please fax the entire confirmation. Thanks. Sara 713-646-3490 (fax)
Sara, do you want to get copies of all the Transactions with this person?	Would you please get copies of all outstanding Transactions with this counterparty? Thanks. Sara
Sara, I don't believe I have ever gotten this file.	Joanne: I don't believe I ever got this file. Thanks. Sara
It seems like a great day on November 15.	Hey, Carol! November 15 looks like a great day. Any other day (except Friday) could work. Sara Carol St Clair 10/30/2000 10:36 AM
I'll be in after my morning appointment with Sara.	I have a morning appointment and will be in afterwards. Sara
I'm going to be leaving at 4 pm, I'm trying to revise Annex A.	I'm trying to revise Annex A. Mike Etringer (in Portland) would like for this to go out today. I'm leaving at 4 pm. Thanks. SS
The fine John Suttle was present on 11/13/2000.	fine John Suttle 11/13/2000 08:32 AM
I think it's a good deal for CWt.	fyi - sounds like a good deal for cwt
I haven't heard back from you but I will let you know when I hear back.	I am following up with MS but I haven't received your answer. Will advise when I hear back. SS
Please make sure to put the print on the back of the envelope.	please print
Kaye, please put Suzanne Adams on my calendar.	yes (Kaye - please place on my calendar) Suzanne Adams 09/17/99 04:15 PM
Sara, can you please tell us about the 2000 Defintions, that's what I said in the earlier email and the one below?	Per my earlier email and the one below, could you please let us know about the 2000 Defintions? Thanks. Sara
Greg: I spoke with Joe who stated that he was working on an internal rate swap with John.	Greg: I spoke with Joe and he IS working on the internal rate swap with John (i.e., ECC/RMT and RMT/ENA). Sara
I don't know what I'm going to do.	fyi
Sara was a part of our conversation.	Per our conversation. Sara
You probably didn't know that both of the settlement'termination requests were made in Euros.	Of course. You probably forgot that SITA requested both settlement'termination in Euros. SS Tanya Rohauer 11/30/2000 10:34 AM
ENA always wants to include an Annex B with this Counterparty, so please keep in mind that Legal will need to review each time.	Sheetal: Please note that ENA will ALWAYS want to include an Annex B with this Counterparty. Legal will need to review each time. Thanks. Sara
We need to enter Lotus Notes so that we can track it.	Please enter into Lotus Notes so that we can track.
Please let Randy know that I have another meeting coming up.	Please let Randy know that I have another meeting scheduled at that time. Thanks. Sara Elizabeth Serralheiro@ENRON_DEVELOPMENT 04/25/2000 05:53 AM
Please let me know if you had a chance to review Dale's product description.	Have you had a chance to review Dale's product description? Please let's discuss. Sara
I would like to know if this prints okay.	let me know if this prints ok
Kaye Ellis said yes, please.	Yes, please. Kaye Ellis 06/05/2000 10:34 AM
Kaye, please don't worry about credit, please focus on confirmations and settlements.	Kaye: Don't worry about credit. Please focus on confirms/settlements. Tana will handle global contracts. Thanks. Sara
It's information that's important.	FYI!!!!!!!!!!!!!!!!!!!!!!!!
Yes, definitely.	sure
Please see that Jeff Nogid and Clint Freeland are given access to the financial trading agreements database.	Tana: Please see that Jeff Nogid and Clint Freeland are given access to our Financial Trading Agreements database. Thanks. Sara
Sara, can you let me know what products you are interested in trading? Mike Fowler@enRON 08/08/2000 12:43 PM	Yes. Sara P.S. Can you call me and let me know what products you are looking to trade online. Mike Fowler@ENRON 08/08/2000 12:43 PM
Sara P.S., who will handle credit derivatives if you're not there? Rod: The debt is being transferred to DLJ and we oweDeutsche Bank for the unwind of the loan swap.	Rod: Further to my recent memo, the Tokheim debt is being transferred to DLJ (and we owe Deutsche Bank for the unwind of the loan swap). Sara P.S. Who will handle credit derivatives in your absence?
Sara, London legal should coordinate with you.	Rod: London legal should coordinate with you. Sara
You can find it at: www.winemall.com.	go to : www.winemall.com
Is PacificCorp Power Marketing, Inc. legal? Is it an entity for financial power?	Kim: Is the legal entity for PacificCorp: PacificCorp Power Marketing, Inc.? Is there only an entity for financial power? Thanks. Sara
Do we agree to the charge interest for early payments, earlier than our usual 5 day period after the floating price is determined?	have we ever agreed to this (charge interest for different Payment Dates) for early payments (i.e., earlier than our usual 5 days after the Floating Price is determinable)? SS
These are for ENA/ECC deals.	These are for ENA/ECC deals
Sara, I just heard your voice mail, can you please fax or email the final confirm to me?	Hi, Greg: Per my voice mail, could you please email or fax the final confirms to me? Thanks. Sara
Click on the doc to find the language you're looking for.	Click on doc for language. SS
I think that's correct.	FYI
I would appreciate if you could tell me if this is a problem.	I would like to schedule the last week of 1999, Dec. 27 - Dec. 30, as vacation. No one else has selected those dates. Please let me know if this is a problem. Thanks. Sara
Please let me know what you need, as we haven't heard anything after sending the draft to the attention of Jim Orsso.	Holly: We sent a draft ISDA to EWEB on 4/19/00 to the attention of Jim Origliosso. We have never heard a word. Please let me know what you need. Sara
You're quick! You're fast! Is there anyone here who doesn't know it?	You're FAST! Brent Hendry@ENRON 08/10/2000 04:59 PM
I'll give you the revision below if you don't mind the second attachment.	Joanne: I'll hand you the revision to the template below (ignore the second attachment). Sara
We'll be in BA during the week of Feb. 28 to meet with lawyers, accountants, commercial group, etc.	Lynn and I will be in BA during the week of Feb. 28 to meet with lawyers, accountants, commercial group, etc. Just a heads up for you. Sara
After 10 am Houston time is fine, I would appreciate a call to discuss the legal opinion.	Would you please give me a call to discuss the legal opinion. After 10 am Houston time is fine. Happy New Year. SS
Here it is.	Here it is
Sara, I want to make certain that we haven't missed anything, and I'm interested in knowing if anyone is involved in Houston.	Can you give me a little more info on this topic? Is anyone in Houston involved? I just want to make certain that we haven't missed anything in the process. Thanks. Sara
Only Sara can tell you that we will sign the Lehman Isda Master Agreement soon.	FYI only. We will execute the Lehman ISDA Master Agreement shortly. Sara
Mark, do you know if ENA can enter into derivatives with an Indian company?	Mark: I've been asked whether ENA can enter into derivatives with an Indian company. Do you have research regarding legality/enforceability since the 1997 global review which ENA conducted through Allen & Overy? Thanks. Sara
Sara would like to have a discussion with Marval.	I would like to pursue with Marval. Should we meet to discuss? Sara
Sara asks how serious this inquiry is and how it will require work on the legal side.	Paul: Please see below. How serious is this inquiry as it will require some work on the legal side? Sara
That's correct.	FYI
Sara, where is this meeting held?	Did you schedule this meeting for me? Where is it held? Sara
Is there any chance that we can update this information?	Can we update this information? SS
I heard a binding agreement was signed by MOEMA for a 10 year transaction, but do you have an English version?	I hear that a binding agreement and/or PPA was signed with MOEMA for a 10-year transaction. Do you have an English version of the MOU or PPA? Details? Thanks. Sara
It looks like there is more waiting.	FYI - looks like more waiting
In the first paragraph, I mentioned " Enron Comercializadora." I should have stated " Enron Comercializadora deenergia Argentina S.A."	In the first paragraph, my reference to "Enron Comercializadora ..." SHOULD READ "Enron Comercializadora de Energia Argentina S.A."
Sara can be contacted by reference to tax attorney.	Please see reference to tax attorney below. Sara
That's correct.	FYI
Please put it in writing.	please print
Mary: I am absolutely correct that it is a good day.	Mary: Thanks so very much! And you're absolutely right about it being a good day! Sara Mary Ogden 12/04/2000 04:26 PM
I think that's correct.	FYI
Sara is looking like she may have a problem.	Russell: Please call - looks like we may have a problem. Sara
Aneela Charania asked if you also have fax and email address.	Do you also have fax and email address? Aneela Charania 11/29/2000 01:00 PM
Please call if you have any other questions or have any questions of your own, I would love to hear from you.	I hope Bruce's explanation is sufficient! Please call me if you have any other questions. Thanks. Sara
I'd like to hear from you, if you're still living in London and working for the bank.	Are you still living in London working for the bank? Give me a call, sometime. 713-853-5620. Thanks. Sara
Thanks a lot.	Thanks. SS
Kaye, I need you to redlined the attached doc, I have it in my office.	Kaye: I need for you to redline the first attached doc. I have the markup in my office. I need to email it tonight. Thanks. Sara
Sara: I'll fax you the online version of the confirm if you need it.	Jarrod: Just in case you needed the online version of the confirm. I will fax my markup to you. Sara
I would like to take a day off and not have to worry about conflicts.	I would like to take this as a vacation day. Are there any conflicts? Thanks. Sara
Rod, do you have a chance to speak with Dale?	Rod: Did you have a chance to speak with Dale? SS
Has this been finalized?	Has this ever been finalized?
I am told that, as I mentioned before, that, as well, that, that, that, that, and that, that, that, that, that, that, that, that, that, that, that, that, that, that, that, that, that,	FYI - also, as I mentioned, Janine should have her conclusions Tuesday. Sara
Sara: Thanks for attaching, I'll make sure I'm on the right side of the law.	David: Pursuant to our conversation, attached is my blackline. I'll verify jurisdiction. Thanks. Sara
Call if you want to take a look.	Please take a look and call. SS
Sara asked if these could go into the rotation.	Mark: Can't these go into the rotation? Sara
Sara, please give me a second day to review your email.	David: Please give me another day to review your email. Thanks. Sara
I thought we sent it, but I'll have a copy of it right away from Marie Heard.	I thought we sent it but I'll have Marie Heard email a copy right away. SS
false alarm.	false alarm
With pleasure!	With pleasure! SS
Sara, have you had any luck?	Frank: Have you had any luck? Sara
If you want to conference with me please let me know at 3 pm (Houston time) when this call has changed to 800-211-2519 800-211-2519 800-211-2519 800-211-2519 800-211-2519 800-211-2519 800-211-2519 800-211-2519 800-211-2519 800-211-2519 800-211-2519 800-211-2519 800-211-2519 800-211-2519 800-211-2519 800-211-2519 800-211-2519 800-211-2519 800-211-2519 800-211-2519 800-211-2519 800-211-2519 800-211-2519 800-211-2519 800-211-2519 800-211-2519 800-211-2519 800-211-2519 800-211-2519 800-211-2519 800-211-2519 800-211-2519 800-211-2519 800-211-2519	This call has been changed to 3 pm (Houston time) which is 5 pm (Sao Paulo time). Please let me know if you would like for me to conference you in. Sara
Sara is free after 11 am.	I'm free after 11 am - Sara
Hey, let's talk on Tuesday.	let's talk on Tuesday, dude
I believe he'll come back next week.	Yao went back to Africa! I think he'll return next week. SS
From a legal and credit perspective, the execution of the No Interest Letter is fine.	Rod Nelson in credit forwarded the Gulf request and attachments. ECTC's execution of the No Interest Letter is fine from a legal and credit perspective. I agree wtih your analysis. Sara
Matt is asking about this agreement because he has a London paper trader nagging him.	Matt Dawson in London was inquiring about this agreement. He'll want to know when we are finished because he has a London paper trader nagging him. SS
I'm curious if the provisions are in fact in our language.	Tana: attached are the L/C provisions for the Deutsche Bank Master. Would you please verify that the provisions are in fact our language? Thanks. Sara
There was nothing attached to Taffy Milligan.	nothing attached Taffy Milligan 04/13/2000 07:36 PM
I'm not quite sure what to make of it.	fyi
My voice mail was sent and I wanted to make sure that you called as soon as possible.	Per my voice mail. Please call ASAP. Thanks. SS
Please fax or email, I will print it for you.	please print - thanks
I would like to know if you would include all of the holidays for Enron Corp., as well as the holidays in Argentina and Brazil, on my calendar.	Would you please incorporate all holidays for Enron Corp., Enron Argentina and ESB (Brazil) onto my calendar? Thanks. Sara
Before I forget, please document the account we used to receive money from in connection with metals trading, so I can remember.	Susan: have you heard anything? Also, before I forget, please document the account in London with CSFB that we used to receive money in connection with metals trading.
Please ask paralegals, and the answer is yes, and there is a special EOL format.	ask paralegals, the answer is yes, and there is also a special EOL format (I believe) Brent Hendry@ENRON 07/25/2000 09:16 AM
For Monday.	For Monday
Sara will be fine with that.	That will be fine. Sara
Thanks for taking the time to give me a thank you.	Thanks, Brenda.
I need your help.	I need your expertise. Attached is only a start. SS
I will be out on Monday and Tuesday and will have to get a backup. Sara, please let me know if you have any more information.	Gareth: Per your voice mail. Marcus thought this was closing next week. I will be out on Monday and Tuesday and will have to find a backup. Let me know if you have further info. Thanks. Sara
I'd appreciate it if you could give me a call or email with the latest form of agreement that ENA should be using with its outside consultants.	Michelle: Could you please send me the latest form of agreement that ENA should be using with its outside consultants? Thanks. If you have any questions, please give me a call. Sara
Sara Shackleton works at 1400 Smith Street, Houston, Texas 77002 and can be reached by phone at (713) 856-3490 or email at Sara.shackleton@einhardt.com.	Sara Shackleton Enron Wholesale Services 1400 Smith Street, EB3801a Houston, TX 77002 Ph: (713) 853-5620 Fax: (713) 646-3490
Edmund apparently took no of my suggestions after I commented to him on this confirm last Friday.	Yes, please call. I actually commented to Edmund on this confirm last Friday and he apparently took none of my suggestions. Sara
We need an item from credit for the draft to go ahead, so do you want a copy?	The draft is ready to go but we need one (1) item from credit. Hopefully, this should be resolved within the hour! Do you want a copy? SS
The agreement must be executed by someone at a higher level.	The agreement must be executed by a VP or higher level. Do you want us to have Jeff Shankman execute? SS
I will call you anyway despite the fact that tax does not have an answer.	Surprise! Tax does not yet have an answer. But I'll call you anyway. Sara Dale Neuner 11/03/2000 04:00 PM
I want to make sure you know that my Utah counsel is going to review and call you tomorrow.	I have requested Deseret's bylaws from David Crabtree. Our Utah counsel will review and call tomorrow. Let me know if you have any other questions. Sara
Thank you, Sara, for calling with a request for a sample.	Marcie Youngerman just called with a request for a sample ISDA. No CP name. Exclusions included. Today. Thanks. Sara
I'm looking for a blue file for a year-end negotiation, so I'm asking if anyone has it.	I am looking for this blue file for a year-end negotiation with CSFB/Enron Corp. Does anyone have this file? Please let me know ASAP. Thanks. Sara
Sara has a "fiery" Allegheny status.	FYI Allegheny status - Sara
12001.	11001
John only had one issue, which was " inhouse" vs "outside" counsel legal opinion.	FYI - John's only issue was "inhouse" vs "outside" counsel legal opinion. And he apologized profusely. No harm done. Sounds like you did a good job. Have a great weekend. Sara
Please put it on my calendar.	Please put on my calendar. SS
This affects EOL trades, but didn't know if you were aware of the issues.	FYI - this impacts EOL trades; didn't know if you were aware of these issues.
Kim, can you tell me the name of the bond counsel inGlendale?	Kim: Can you obtain the name of Glendale's bond counsel (lawyer's name, phone number, email, etc.)? Thanks. SS
I received a message from Anna Chung at Merrill, she is at the ENE master. I also left Vm for Jeff to send down deemed ISDA's or other confirms.	I just received a message from Anna Chung (?) at Merrill re: the ENE master. Her number is 212-449-7494. I also left vm for Jeff to send down deemed ISDA's or other confirms. SS
The list that Marie prepared for me is a good start but we still need a detailed description of the process.	Attached is the list that Marie had prepared for me just last week (the date at the top is incorrect) which is a good start. We will still need a detailed description of the brokerage agreement process. Sara
Our conversation was mentioned per our conversation.	per our conversation
You can call in the number.	see call in number
Only item 14 can be printed.	please print item 14 only
The second email is from the same sender.	the second email
Sara has a good way of handling things.	FYI and handling. Sara
For now, please hold off on hedge funds.	Jason: please hold off on hedge funds for the moment. Paul may need to rethink the provisions. Sara
Sara, please call me when you have a chance to review.	John: Please call me when you have had a chance to review. Sara
Let me know when you want to have a conversation.	Let me know when you want to talk. SS
Sara will call.	I'll call. Sara
I think it's important.	FYI
I am hoping you are well, but how do I get in touch with you?	Hope all is well. How do I get in touch with you? Sara
Sara, I would appreciate it if you continued to follow up with Fimat in New York to ensure receipt of the original guaranty.	Stephanie: Would you please continue to follow up with FIMAT in N.Y. to ensure receipt by us of the orginal guaranty? Thanks. Sara
Sara: Are you going to send the draft credit agreement with the ABN Amro guaranty?	Joel: Are you also going to send out the ABN Amro guaranty? We're sending the draft credit agreement. Sara
There is an attachment for a draft confirm.	Joe: see the attachment for a draft confirm. Pat: Here's Julian's proposal.
Mark was going to handle Hawaii and I didn't read all of the emails.	I haven't read all of the emails, but, Mark was going to handle Hawaii. SS Mary Cook 08/29/2000 08:14 AM
The Global Finance Tana Jones was in action on June 26, 2000.	Global Finance Tana Jones 06/26/2000 01:30 PM
I will not be in the office tomorrow, so I would like to hear from you if we need to discuss anything.	I will not be in the office tomorrow. Please contact me today if we need to discuss anything. Thanks. Sara
We have to check with Harlan on Friday, I already spoke with him.	I already spoke with Harlan. We need to check with him on Friday. Sara
Jeff says that the language of floating price is ok.	Jeff says Floating Price language is ok. SS
Bill, the conference call number is here. There is likely to be a major issue relating to cashcollateral (see item 11 under the "Isda Schedules" section of the memo).	Bill: Here's the conference call number. THERE APPEARS TO BE A MAJOR ISSUE RE: CASH COLLATERAL (see Item 11 under the "ISDA Schedules" section of the memo.
Sara is the link that I can't reach.	Below is the link that I cannot reach. Sara
Sara has the latest from CSFB.	the latest from CSFB - Sara
Jane, I forgot to mention that I will need to have our Japanese outside counsel review the "credit section." Who should I be dealing with?	Jane: I forgot to mention that I will need to have our Japanese outside counsel review the "credit section." Who should I be dealing with? Sara
More.	more
How are we handling the dual agreement situation?	How are we handling the "dual agreement" situation? Have we spoken with credit? Stephanie Panus@ENRON 08/21/2000 09:09 AM
I've set up a meeting with Guy on March 30.	I've scheduled a meeting with Guy on March 30 Susan Bailey 03/10/2000 08:59 AM
Sam, please let Russell know that Cinergy is going out today.	Sam: Please be sure to let Russell know when Cinergy goes out today. He should have sent you the addressee. Sara
Sara, thanks for the update, but can you tell me about the Japanese desk principal?	Janine: Thanks for the update. Any word on the Japanese FX desk principal? Sara
Let's talk later.	FYI. Let's talk later. SS
Susan, I'd like to fax you the file and a blackline. Marie already made most of the changes.	Susan: Could you please create a blackline and fax to Cargill. Marie already made most of the changes. Thanks. Sara ps - file is on your chair
I am wondering if there are any problems with the addition of Dec. 7 as a vacation day.	I would like to add Dec. 7 as a vacation day. Please let me know if there are any problems. Thanks. Sara
There will be a meeting in OCS at 2 pm on Tuesday.	The meeting will be held in OCS 04075 at 2 pm on Tuesday (March 19). Sara
If you would like to call in to discuss the issues, you can use the dial-in number.	here's the dial-in number if you want to call in to discuss the guaranty issues
We can grab her in the morning if we want to, but she can't meet this afternoon.	Bob: attached is Melissa's update. She cannot meet this afternoon but we can grab her in the morning. Are you flexible in the a.m.? SS
When will you be able to give me a heads up after theDeutscheBank call?	Bill: Thanks. When will you have some time? Maybe tomorrow after our DeutscheBank call? SS William S Bradford 09/12/2000 07:18 AM
Friday, December 29 will be a vacation day for me.	I will be taking Friday, Dec. 29 as a vacation day. Sara P.S. I will also be on vacation Dec. 7 & 8.
Please tell us what dates are available and we can schedule as soon as possible.	Per our conversation, please advise of available dates. We would like to schedule as soon as possible. Thanks. SS
Carol St Clair was present on April 19th, 2000.	yes Carol St Clair 04/19/2000 11:18 AM
Anne will try to get the email for the master on Monday.	Anne: Thanks for your voice mail. We would like to generate the master. I'll try to have it emailed on Monday. Regards. Sara
It's too late to respond, but I'll let you know.	Travis: I received this on 11/17 and I was on vacation. I think it's too late to respond but let me know. Sara
Sara hopes this helps.	hope this helps - Sara
Sara Eleanor Fraser apologized for it and said it was and that it was.	It was and my apologies. Sara Eleanor Fraser on 06/29/99 10:09:57 AM
No, that's not true.	no
Excellent! Sami Arap@ENRON_DEVELOPMENT on February 15th, 2000.	Great! Sami Arap@ENRON_DEVELOPMENT 02/15/2000 05:39 AM
Kaye told me that the hotel that you and Mark recommend is not an approved hotel. Do you know of a nearby hotel that is approved?	Kaye tells me that the hotel that you and Mark recommend is not an Enron approved hotel.(I think it's a Sheraton?). Do you know a nearby hotel which is approved? We can chat during our later call. SS
Is this a request for you? Sara, askSheila, 12/08/2000 03:41 PM	Sheila: Is this a request to me? Sara Sheila Glover 12/08/2000 03:41 PM
I left Evelyn Aucoin a message to give her a more detailed explanation about the financial gas and power settlements.	Evelyn Aucoin (financial gas & power settlements) I left her a message to provide a more detailed explanation.
Susan, can you send a " blank form Paragraph 13 for this master?", just our standard, even though there are blanks.	Susan: While Tanya is reviewing credit, can you please send a "blank form Paragraph 13" for this master. Just our standard. Caveat: subject to credit review even though there are blanks. Thanks. Sara
Sara needs to keep this for future reference.	Keep this for future reference. Sara
Julia: To close the loop, it appears that the swaps weren't terminated.	Julia: To close the loop, it appears that none of the swaps were terminated. Sara
Between 12 and 4 on Thursday and between 11 and 2 on Tuesday.	Thurs: between 12 -4 Tues: between 11 - 2, after 3
Please tell me what you think, I'm wondering if this is the deal that we lost.	Is this the deal we lost? Please tell me what you know. ss p.s. Welcome back.
Kaye wants to know if it can be printed on legal paper.	Kaye: Can this be printed on legal?
I spoke with Steve Kessler and he told me that he agreed with Carol regarding net commodity transactions, even though he didn't like the idea of net within other product groups.	I spoke with Steve Kessler this morning. He told me that he agreed with Carol to net commodity transactions (which was actually more than he wanted to agree to!). However, DB does not have the systems to net within other product groups. Sara
I have not received any forwards or puts from CSFB. Sara, have you heard anything else?	FYI - I have not received any forwards or puts from CSFB. Have you heard anything further? Sara
I will ask Tana to finalize if I see a copy of this message.	You are correct. By copy of this message, I will ask Tana to finalize. Sara William S Bradford 10/25/2000 07:55 AM
There are two more electronic agreements, please enter them into the database.	Jason: Two more electronic agreements. Samantha: Please enter into database.
We don't want to ask for authorization at this time.	We are not seeking authorization at this time.
John asked if he had talked to John Nicholson. Sara asked if he had talked to John Nicholson.	John: Did you speak with John Nicholson? I need his phone number please. Call me. Sara
Sara, someone needs to explain what's going on.	Someone please explain. Sara
My voice mail is sent per my voice mail.	per my voice mail
Susan said they will open a futures account with Bank One and that they had sent a give up agreement.	Susan: We are going to open a futures account with Bank One. They have also sent a give up agreement. This message is FYI.
I'll be at Chaundra Woods on 11/29/2000.	I will attend. Chaundra Woods 11/29/2000 04:49 PM
I didn't get a reply from anyone.	I have not received a response from anyone. Sara Mahesh Lakhani 10/06/2000 03:22 AM
There is a new credit spreadsheet for Capex.	Attached is a new credit worksheet for Capex. SS
Please make sure that the attached guaranty is executed.	Please have the attached guaranty executed. SS
I need a file for "Yen CLN- Merrill Lynch", and I don't know if the last 48.5 hours will be on Sept. 30.	Thanks. Is the 48.5 hours remaining on Sept. 30? Also, I need a file for: "Yen CLN - Merrill Lynch"
There are provisions in the memo that should be of interest to you.	check out the provisions in the memo about the guaranties
I would like to take Friday, December 8th as a vacation day, but I would like to make sure I don't have any conflicts.	I would like to take Friday, Dec. 8 as a vacation day. Please advise of any conflicts. Sara
I'm only sending this message so that I don't forget, I know it's on your list.	I know it's on your list. I'm only sending this message so that I don't forget! ss
The swap piece is in the process of being reviewed.	Attached are summary documents. I am in the process of reviewing the swap piece now. Sara
Sara P.S. EWEB hasn't commented on the CSA.	Ed: Please respond to item (2) regarding EWEB. Thanks. Sara P.S. EWEB has not commented on the CSA.
I need you to contact me so that I can be at my house for the installation of the alarm this afternoon.	I need to be present for my home burglar alarm installation this afternoon. Please feel free to contact me at (713) 664-3207. Thanks. Sara
My voice mail is re: end of life.	Tana: per my voice mail re: EOL.
Sara, can you give me a quick look at the BofA file?	Can I take a quick look at the BofA file? Thanks. Sara
I spoke with Joann Bigwood at Harvard and she will negotiate the agreement.	I spoke with Joann Bigwood at Harvard and she will negotiate the agreement. We will comment to their prior draft. I'm in CA until Thursday. SS
You can still agree to these IDENTICAL early terminates until otherwise notified by credit.	With respect to this counterparty, you may continue to agree to these IDENTICAL early termination provisions until otherwise notified by credit. SS Bernice Rodriguez 06/22/99 04:35 PM
If you want me to ask someone else the question, please let me know.	Hi, Mark: Hope you're doing well. Mark Taylor had suggested that I ask you the question below. If you suggest that I ask someone else, please let me know. Thanks. Sara
I would like to ask Anne or Francisco to handle it.	Stephanie: Can you please ask Francisco or Anne to handle? Thanks.
I left the text on your chair.	I left the markup on your chair - Sara
You might want to check with Sara after reading Pat's message.	See Pat's message below. You may want to check with her. Sara
Sara: Please send an executed copy to Susan Flynn for ENA's files.	Brenda: This looks fine. Please have an executed copy sent to the attention of Susan Flynn (for ENA's files). Sara Brenda L Funk 03/27/2000 04:57 PM
Susan Flynn sent an email to Nancy a few days ago, but it looks like Rafael didn't read it.	Sheila: Looks like Rafael never read the email that Susan Flynn sent to Nancy a few days ago. I don't know where this stands. Sara
The definition of ESP was taken from the commodities regulations.	Attached is the ESP definition taken from the commodities regulations.
Marie has tried to get the attention of Central Puerto, but they have not been interested in her requests.	Central Puerto has been unresponsive to Marie's requests for original documents. Can someone please contact Marie and help us speak with the counterparty? Thanks. Sara
I'm talking with an inhouse PUHCA lawyer.	fyi - am speaking with an inhouse PUHCA lawyer
Please make sure you print it.	please print
We are in the midst of transferrring a swap from Merrill to Lehman and we are in need of your help.	Bill and Tanya: Clint would like to finalize Lehman and CSFB, in that order. We are in the midst of transferrring a swap from Merrill to Lehman. Thanks for your help. Sara
Please join us for a lively discussion if your schedule permits, as we have scheduled a meeting in my office at 9:00 am on Friday.	Tanya and I have scheduled a meeting in my office to discuss SITA at 9:00 am Friday morning. Please join us for a lively discussion if your schedule permits. Sara
I didn't hear back.	no - I never heard back
I would appreciate it if you could call me at a given time per voice mail.	please call me per voice mail.
I rely on the 11/30/01 calculations from Mexico, but I don't know if he worked with credit.	FYI, Mexico. I'll rely on your 11/30/01 calculations. I don't know if Jaime worked with credit. Sara
I would appreciate if you could give me a copy of the final.	Could I please have a copy of the final? SS Dale Neuner on 06/24/99 03:52:33 PM
I won't be able to attend the meeting as I have a doctor's appointment, but I will get to hear about Friday's luncheon.	I will not be able to attend this afternoon's meeting as I have a doctor's appointment. Also, I am looking forward to hearing details of Friday's luncheon. Thanks. Sara
Are you aware if he's in Houston this week or early next week?	Have you heard if Brent will be in Houston this week or early next week? SS
Sara Marty_Oelmann@cargill.com, you'll hear from me after lunch.	Marty: I'll call you after lunch. Thanks. Sara Marty_Oelmann@cargill.com 05/26/2000 11:39 AM
Please tell me when you're ready for the back-to-back.	Please advise when you guys are ready for the back-to-back. SS
Robert Bruce@ENRON wrote: " Rats! Robert Bruce@ENRON."	Rats! Robert Bruce@ENRON Sent by: Robert Bruce@ENRON 09/21/2000 10:10 AM
Marcus, please tell me what I need. Who is booking the confirmations?	Marcus: Can you please let me know what you need. Who is handling credit? tax? accounting? Who is booking the confirmations? Have the confirms been drafted or negotiated? Any changes? How many transactions? Sara
I received the email from the bank and attached a redline of changes, so let me know if you have any objections.	Greg: I received the following email from RBC and am attaching a redline of changes. Since ECC will be signing, let me know if you have any objections. Sara
Sara, would you please send a copy of the referenced agreement to Ellen Su (30th floor - Gary's group)?	Susan: Would you please send a copy of the referenced agreement to Ellen Su (30th floor - Gary's group). Thanks. Sara
Gary should review this message.	Please have Gary review this message.
You can see a doc for making revisions.	see the doc below for making revisions. ss
Can you remind me what I need to do in order to print spreadsheets?	please print - and - can you remind me what I need to do in order to print spreadsheets? thanks
There is a reason the Lehman MASTER AGREEMENT hasn't been executed.	Here's the reason the Lehman MASTER AGREEMENT has not been executed. SS
That's correct.	FYI
Sara, please tell me that the file is currently inactive.	Please confim that this file is currently inactive. Thanks. Sara
Cheryl asked Sara Cheryl Nelson if we could meet for a few minutes after 9 am tomorrow.	Cheryl: Can we meet for a few minutes after 9 am tomorrow? Sara Cheryl Nelson@ENRON Sent by: Cheryl Nelson@ENRON 01/02/2001 01:54 PM
I don't know if that's true.	fyi
We'll have a break after 3pm and we'll call you again to discuss tax and then we'll meet with Lynn and Rick at Allen Center.	I'll call you at 3pm BA to discuss omnibus. Then we'll break and I'll dash over to meet with both Lynn Aven and Rick Hopkinson at Allen Center and we'll call you back to discuss tax etc. SS
This applies to all of the other counterparties.	This applies to all counterparties!
Kaye, I have attached your message from Tuesday and you can schedule an hour in my office with me to discuss power confirms.	Kaye: Attached is my message from Tuesday. Also, please schedule an hour in my office with Melissa Murphy (31886) to discuss power confirms. SS
You should add a rep that the Irrigation District has the authority to enter into the deal.	The Merced Board resolution is unclear. You should add a rep that the Merced Irrigation District has the authority to enter into the deal. Sara
I want to know by the end of the day.	please let me know by the end of the day today. thanks. ss
On Friday, did you send the Tiger guaranty to the executioner?	On Friday, did you send the Tiger guaranty to Clem for execution? SS
The second message is here.	Here's the second message.
The tax rep modifications are due to be reviewed on Thursday, Sept. 30.	This is an ECM deal which is supposed to fund Thursday, Sept. 30. Would someone please review the tax rep modifications? We just received the attached at 5:45 pm this evening. Thanks. SS
Mark: how should we handle this? In the past, I have supplied physical trading forms for Tozzini to use.	Mark: How should we handle this? In the past, I have provided Andrea Bertone with Elizabeth Sager's latest (and evolving) physical trading forms which Tozzini has used as a starting point. Sara
Were you talking to these guys?	Did you talk to these guys?
We won't accept Kern's letter.	We will not "accept" Kern's termination letter.
On 11/30/00, Susan sent the docs to Larry Johnson and John Porter.	Joe: Susan emailed the docs to Larry Johnson and John Porter on 11/30/00. Joseph Wagner@ENRON 12/11/2000 11:27 AM
Sara, if this looks alright for execution, do you think so?	John: Does this look alright for execution? Sara
Please call, it sounds like we should accelerate our plan.	FYI - Brent please call. Sounds like we ought to accelerate our plan. SS
Is it Russell who is handling the "Cargill-Alliant, LLC" credit?	Hey, Russell: Are you handling the "Cargill-Alliant, LLC" credit? Sara
There's only one thing that's good about it.	FYI only
Kaye Ellis, thanks for taking the time to say thank you.	Thanks. SS Kaye Ellis 01/31/2000 10:21 AM
The issue of the waivers of conflict in these agreements is something that I'm trying to address.	Attached is my effort to address the waiver of conflict issue in these agreements.
It should be canceled. ss Shari Stack 11/23/99.	consider it cancelled. ss Shari Stack 11/23/99 06:30 PM
Sara, if you're interested, please call me or we'll agree on a time.	No more voice mails. Call me or let's agree to a time. Sara
I sent the byes to the Utah counsel who is in NY, but haven't heard from him.	I received the bylaws this morning and forwarded them to Utah counsel (who is in NY). Left 2 messages with his office. Have not heard from him. I'll call again. SS
Susan, Steve Morus called and asked for you to email him theCSA for comment, and that info is already in the database.	Susan: Steve Morus called and would like for you to email to him the schedule/CSA for comment. Info already in database. Thanks. Sara
I would like to discuss, I have a slightly different version, please let me know when you can talk.	Edmund: Attached is a slightly different version of DTD Brent which I have= =20 drafted. I would like to discuss. Please let me know when you can talk. = =20 Sara
We'll do it and send it back.	We'll do that and resend. Brent Hendry@ENRON_DEVELOPMENT 02/25/2000 07:42 AM
Another Vitol message came from tkare.	Tanya: another Vitol message
Marcus: The Master is not an Ista. I'm pretty sure there will be problems matching terms for the swaps.	Marcus: The MSCG Master is NOT AN ISDA! I am sure there will be problems "matching" terms for the swaps. sara
We need to confirm that Rod will be available at 3 pm Houston before we speak.	Julian, 5 pm BA time is 3 pm Houston. Before we speak, please verify that Rod will be available at 3 pm Houston. Julian Poole@ENRON_DEVELOPMENT 04/26/2000 06:51 AM
Mark, please call me if you have a chance, and let me know if you have spoken with the Marval firm about this.	Mark: have you spoken with Brent or the Marval firm about this? Please call me when you have a chance. Thanks. Sara
Let's get this signed and fax it in.	Let's have this signed and fax per below. Thanks. SS
I'll call you later on when I have a conference call with EWEB's lawyer.	Holli: I have a conference call with EWEB's lawyer at 9 am PST. I'll call you later. Sara
I would appreciate it if you could help me get a flat panel monitor to replace my current one.	Mark: I would like to request a flat panel monitor to replace my current monitor. Thank you. Sara
My voice mail is for the project "RmT!," and I would appreciate if you would forward it to me.	PLEASE HEAR MY VOICE MAIL! This is a project for RMT! SS Dale Neuner on 08/05/99 09:23:14 AM
Before further distribution, I wanted to make certain that we were in agreement and I wanted to review and comment on the attached format.	Subject to any deal changes, please review the attached format and comment. Before further distribution, I wanted to make certain that we were in agreement. SS
Kelly Templeton asked, "Do you have a phone number?"	Do you have a phone number? thanks Kelly Templeton@ENRON 04/13/2000 10:59 AM
Sara David P Dupre, I have you on my calendar for 2 pm on Thursday.	I have you on my calendar for 2 pm on Thursday. Sara David P Dupre 11/02/99 05:03 PM
I received a message, but I'm not sure if the name rings a bell or not.	I received a message without further identification and I'm momentarily baffled. Maybe the name rings a bell. Thanks. Sara
I'm not sure of the relationship between the two banks and if the 7/1/95) ISDA will be transferred to the UK bank.	Are you aware of this? I don't know the relationship between these two banks and whether our 7/1/95 ISDA will be transferred to the UK bank. Let me know if you have any information. Thanks. Sara
It's true.	FYI
Sara, will lunch be one day next week?	yes. Lunch one day next week? Sara
It's per vm.	per vm
Will you miss Alec?	Won't you miss Alec?
Sara Mike Fowler, thank you, we did not need anything from you yet.	Mike: We have sent our comments. We do not need anything from you yet. Thanks. Sara Mike Fowler@ENRON 08/21/2000 09:46 AM
This is true.	FYI
Rick is going to try to remind everyone to include their name on new account requests.	Rick: I'll try to remind everyone to include your name on new account requests. Sara P.S. Paul represents "Enron Credit Inc."
We need this asap.	This is the doc for revision. We need it asap. Thanks. SS
Sara Shackleton has a office at 1400 Smith Street in Houston, Texas.	Sara Shackleton Enron Wholesale Services 1400 Smith Street, EB3801a Houston, TX 77002 Ph: (713) 853-5620 Fax: (713) 646-3490
I know that the parties wanted to close today, but I don't know if we're agreed about the calculations I forwarded to you on Wednesday.	Ben Bedell, the lawyer for BT, has called to about the calculations I forwarded to you on Wednesday. Are we agreed? Please let me know asap. I know that the parties wanted to close today. Sara
Sara: I received an email from Steve Curlee in which he said "Who is performing legal/credit for Enovate?"	Kay: Attached is the email I received from Steve Curlee. Who is performing legal/credit for Enovate? Sara
Gary: We haven't seen the draft of yours, so we need to act fast. How long will it take for you to execute?	Gary: I believe we are having our guaranty executed. We haven't seen the draft of yours. Please send ASAP. How long will it take for you to execute? Sara
Sara Adams said that she was going to contact Merrill by phone so they could duplicate for ENA.	Laurel: Samantha is going to contact Merrill by phone and let them know of the preexisting ECT Investments agreement so that Merrill can duplicate for ENA. Sara Laurel Adams 09/11/2000 10:45 AM
The purchaser of the reference loan was identified as Alan Aronowitz.	Alan: we are reviewing docs from DLJ, the purchaser of the reference loan. Alan Aronowitz 05/15/2000 02:42 PM
I am going to have a lawyer call tomorrow morning because I just had someone leave a voice mail for someone who is at an outside meeting. I will definitely have a lawyer call tomorrow morning.	Speak of the deviI! I just had someone leave a voice mail for counsel (who is at an outside meeting). I will definitely have a lawyer call tomorrow morning. Is Utah in your time zone? Sara
Please let me know who is handling the news so I can pass it on to Jeff.	Rod and Tanya: Please let me know who is handling so I can pass on the news to Jeff. Thanks. Sara
Sara, what exchanges do the entries reflect?	Thanks. What exchanges do these entries reflect (e.g., NYMEX only?)? Sara
I have not heard anything in my voice mail, so that's what I'm reporting.	Per my voice mail. I have not heard a word. SS
I'll be here David Minns.	I'll be here David Minns@ENRON_DEVELOPMENT 05/15/2000 01:34 AM
The paragraph is marked on the document.	insert this paragraph as marked on the document. ss
The calendar shows it on my calendar.	It's on my calendar! SS Russell Diamond 09/05/2000 11:25 AM
I can see who would like to add me to their list.	Whomever would like to add to their list can see me. Thanks. SS
Kaye, thanks for asking. Sara: Did you take care of it?	Kaye: did you handle? Thanks. Sara
Mary and I will both try to attend the swap group meeting on August 22.	The swap group has a meeting every other Tuesday, including Aug. 22. Either Mary or I will try to attend. Carolyn George@ENRON 08/21/2000 03:03 PM
We're sending this out until Scott Neal confirms the terms of the deal, and then we'll probably set a trade date at the end of next week.	We are sending this out in draft form until Scott Neal (our "Argentina" trader) has confirmed the terms of the deal with EDEN. The trade date will probably be set towards the end of next week. Sara
Just received the fax.	Just got the fax
Sara, are we ready to send execution copies?	Marty: Also left you a voice mail. Are we ready to send execution copies? Sara
I don't know.	fyi
Sara, I would appreciate if you could print this out for me.	Kaye: Will you please print this out for me? Thanks. Sara
The fax number I use is (713) 646-3490, so I'd like to give you a shout out.	My fax number is (713) 646-3490. Thanks. Sara Ana Cristina Santos@ENRON 07/10/2000 03:17 PM
I don't know if I need to diall in for the conference call.	Do I have to diall in for this conference call?
It was signed by ss Tanya Rohauer.	ISDA signed. ss Tanya Rohauer 07/30/99 07:34 AM
Susan Bailey can have the Tiger guaranty prepared for execution if she calls about it.	Yes, as long as the Tiger lawyers do their bit. Please call Susan Bailey about the guaranty and she can have it prepared for execution. Question: Are we only preparing the Tiger guaranty or other animal guaranties as well? SS
A sample email.	sample email
Sara, I'm sorry, but I'd like you to call Chris.	Thanks for the help. Could you please call Chris? Sara
I'm waiting for a spot in theturing Power Transacations class for Nov. 10 and 11 because I couldn't get one for this one day class.	I have registered for this one day class. I was unable to secure a place in the "Structuring Power Transacations" class for Nov. 10 and 11 and I am waitlisted. Sara
Are you handling it?	are you handling?
"Shorter" is not the actual name of the person who is in the RAC.	FYI - Cassandra Schultz is in RAC (not "Shorter")
I am able to answer questions until 3 pm Remaining gas demand letters will be sent today, I have already received a number of questions on the demands sent on Friday.	I am available until 3 pm Remaining gas demand letters will be sent today. I have already received a number of queries on the demands sent on Friday.
I can attend an event hosted by Enron North America Corp.	yes, I can attend Enron North America Corp.
I don't know.	fyi
The form of "up front collateral" was posted earlier this year.	yes, earlier this year (posted in the form of "up front collateral").
The corporate office of Sara Shackleton is located at 1400 Smith Street in Houston, Texas.	Sara Shackleton Enron North America Corp. 1400 Smith Street, EB 3801a Houston, TX 77002 Neel.Lemon@bakerbotts.com 01/02/2001 01:21 PM
Please help.	help
The meeting will now take place in Conference Room 38C1 at 1:30 - 2:30PM on Thursday, April 20.	The meeting has been moved to 1:30 - 2:30, Thursday, April 20 in Conference Room 38C1.
Good morning! Can you make a copy of the paper?	Good Morning! Can you please print? thanks.
