The executed EEI Master Power Purchase and Sale Agreement will be scanned into Livellink.	We received the executed EEI Master Power Purchase and Sale Agreement dated 8/14/2001 from the referenced CP. A copy will be scanned into Livellink.
If you need more information, please let me know.	Callaway Golf Company International Rectifier Corporation Conexant Systems, Inc. Davis Wire Corporation Fresh Express Incorporated CNC Containers Corporation Let me know if you need more information
The executed EEI Master Power Purchase and Sale Agreement has been sent to us and will be scanned into Livelink.	We received the executed EEI Master Power Purchase and Sale Agreement dated 4/20/2001 from the referenced CP. The document will be scanned into Livelink.
A copy of the EEI Master Power Purchase and Sale Agreement has been sent to us and will be scanned into Livelink.	We have received the executed EEI Master Power Purchase and Sale Agreement dated 8/13/01 from the referenced CP. A copy will be scanned into Livelink.
A copy of the EEI Master Power Purchase and Sale Agreement will be uploaded to Livelink.	We received the executed EEI Master Power Purchase and Sale Agreement from the referenced CP dated 10/31/01. A copy will be scanned into Livelink.
The executed EEI Master Power Purchase and Sale Agreement was received by us. Copies will be given to Legal and Credit.	We have received the executed EEI Master Power Purchase and Sale Agreement dated 6/22/2001 from the referenced CP. Copies will be distributed to Legal and Credit.
We have received the executed EEI Master Power Purchase and Sale Agreements, and will give them to legal and credit.	We have received executed EEI Master Power Purchase and Sale Agreements from the referenced CPs dated 5/2/01 and 6/15/01, respectively. Copies will be given to legal and credit.
I'm looking for it, so I'll get back to you.	I'm looking for it. Will get back to you.
We have received the signed EEI Master Power Purchase and Sale Agreement dated 7/25/2001 from the referencedCP and will give the copies to legal and credit.	We have received the executed EEI Master Power Purchase and Sale Agreement dated 7/25/2001 from the referenced CP. Copies will be given to legal and credit.
The volume should be turned up at the following URL: www.major3d.com/animate/Mouse_Final.	turn up the volume http://www.major3d.com/animate/Mouse_final.mpeg
Copies of the EEI Master Power Purchase and Sale Agreement will be given to legal and credit, after we have received the executed EEI Master Power Purchase and Sale Agreement.	We have received the executed EEI Master Power Purchase and Sale Agreement dated June 14, 2001 from the referenced CP. Copies will be given to legal and credit.
The executed EEI Master Power Purchase and Sale Agreement was received by us and will be scanned into Livelink.	We received the executed EEI Master Power Purchase and Sale Agreement dated 10/29/01 from the referenced CP. A copy will be scanned into Livelink.
We received an EEI Master Power and Purchase and Sale Agreement dated 6/28/2001 from the referenced CP and we will be giving the copies of it to legal and credit.	We have received an executed EEI Master Power and Purchase and Sale Agreement dated 6/28/2001 from the referenced CP. Copies will be given to legal and credit.
There were only financial trades, and they were highlighted and attached to the spread sheet.	Here's the terminated trades for yesterday. There were only financial trades yesteday and I have highlighted them and attached the spread sheet.
The Master Power Purchase and Sale Agreement was executed on 11/6/01, and we will get it scanned into Livelink.	We received the executed EEI Master Power Purchase and Sale Agreement dated 11/6/01 from the referenced CP. The document will be scanned into Livelink.
Today, the name was changed from Cominco to Teck Cominco.	The following Name Overlay was done today: Cominco Ltd to Teck Cominco Metals Ltd.
Please change the emissions deals in the Nevada Report to this one as I discovered that I included two of them.	I discovered that I included 2 emissions deals in the Nevada Report so please replace it with this one.
I'll send you a spreadsheet to show you who we net with.	Susan, can you give me some more specifics on this request. I can send you a spreadsheet to show you who we net with. This request is very broad and hopefully we can refine it. Let me know.
If you're not able to open it, you'll need to go through eRequest to get access.	Sara, try the instructions below in Lotusnotes. The name of the database is New Power Contracts. If you can't open it, you will need to go through eRequest to get access.
I have a message from Tana to let me know if you need me to forward it to you.	Did Tana call you? I have a message she left me about the contract if you need me to forward it to you. Let me know.
