It's always best to have another pair of eyes on it.	Thanks, MK. It always pays to have another pair of eyes on it. Yes, the capacity is posted as available.
I was curious about the link at thecapacitycenter.com/top20pipes.	I thought this link was interesting... http://www.capacitycenter.com/top20pipes.htm
Gary Burleson is with BR.	with BR's Gary Burleson
I'm sure you will, dude. Mark, are you available?	Thanks, dude. You betcha. Mark, are you available?
Here's my second best shot: NatCom Energy Services, Inc.	Here's my best shot(s): NatCom Energy Services, Inc. Streamline Energy Services, Inc. Handyman Energy Services, Inc. Enable Energy Services, Inc. (var. Enerable)
What do you think about the recent action by the FERC to stop the bleeding in California electricity?	So, what do "we" think of FERC's recent action to stop the bleeding in California electricity?
It's not good for this capacity, but it's structured along the lines that we'll probably be seeking in competing proposals.	Falls woefully short of my expectations for this capacity, though it's [structured] along the lines we'll probably be seeking in competing proposals. Let's talk.
We'll try it, but it depends on Mark's schedule and Susan and I'll be out of staff meeting by 2:30 p.m.	Jeff, It depends on Mark's schedule and whether Susan and I will be out of staff meeting by 2:30 p.m. We'll try it.
Guys, good bye...	fyi guys....
The attached brochure is a good reference for the project, I've asked these guys to refresh the status.	The attached brochure is pretty good reference material for the project. I've asked these guys to freshen up the status.
I'm not sure what to make of it.	fyi
Apparently, the entire 200 MMcf/d capacity in the expansion went to one shipper who was willing to charge max. rates for 35 years.	Rumor on the street is that the entire 200 MMcf/d of capacity in the PGT-NW expansion went to one shipper who offered max. rates for 35 years.
Cindy, thank you for taking the time to turn around andTrademarkiaTrademarkiaTrademarkiaTrademarkiaTrademarkiaTrademarkiaTrademarkiaTrademarkiaTrademarkiaTrademarkiaTrademarkiaTrademarkiaTrademarkiaTrademarkiaTrademarkiaTrademarkiaTrademarkiaTrademarkiaTrademarkiaTrademarkiaTrademarkiaTrademarkiaTrademarkiaTrademarkiaTrademarkiaTrademarkiaTrademarkiaTrademarkiaTrademarkiaTrademarkiaTrademarkiaTrademarkiaTrademarkiaTrademarkiaTrademarkiaTrademarkiaTrademarkiaTrademarkiaTrademarkiaTrademarkiaTrademarkiaTrademarkiaTrademarkiaTrademarkiaTrademarkiaTrademarkia	Cindy, Thank you for the quick turn around. You have a great weekend also!
The amendment to the USGT contract is attached.	Attached is the amendment to the USGT contract....
I think we will call you at 3:00 p.m.	I think we said we'd call you at 3:00 p.m. CDT. See 'ya then.
I don't think the "sensitivity classes" are having the desired effect on him, I just don't think that's what they're doing...	I don't think the "sensitivity classes" are having the desired effect on Keith....
I haven't seen you yet, so what do you need to be aware of?	Hey dude. Happy Holidays! I haven't had a chance to look over yet, have you? Anything we need to be aware of? Let's chat when you get back from holidays.
Can you provide any more proof that the state of California will slide off into the sea?	Need any further proof that California is destined to slide off into the sea?
You guys might find the chart interesting. USGT averages about 700,000 MMBtu per month, but it's highly variable.	Thought you guys might find this chart pretty interesting. USGT averages about 700,000 MMBtu per month, but as you can see it's highly variable.
Thanks a lot, we're done with it.	Thanks, dude. We're all over it.
The chart is pretty interesting, but you can see that the USGT averages over a million MMBtu per month.	Thought you guys might find this chart pretty interesting. USGT averages about 700,000 MMBtu per month, but as you can see it's highly variable.
How do you feel when you're called a "predator" by theCPUC prez?	so, how's it feel to be called a "predator" by the CPUC prez?
If you like the new version, please let me know, I took the liberty of rearranging it to better fit the page.	I took the liberty of reformatting it to better fit the page. See if you like it as revised. Lorraine Lindberg 06/13/2000 05:38 PM
