Don't worry, I've changed my mind back to buying and I haven't found a solution to getting your lease calculator to work.	No luck getting your lease calculator to work? Actually, don't worry about it I have change my mind back to buying.
On Oct.30 I e-mailed my mail stop number to Rebecca and then I left her a voice mail message.	Jennifer, I e-mailed my mail stop number to Rebecca Torres (EB3125A) on Oct.30. and left her a voice mail message yesterday. I just sent her the info. again. CD
I bought 5000 from Aquila for May and I was wondering if I could change the financial deal they did to me.	Kathy, Aquila accidentally traded my financial product instead of my physical product. Could you change the financial deal they did to phys? I buy 5000 from Aquila at 3.645 for May. Thanx, Chris
I think they did a spell check.	I think the ran the spell check.
I'll sell it for $29500, after Carmax showed me a $29000 bid.	Carmax showed me a $29000 bid. I'll sell it to you for $29500.
If you didn't get the e-mail I sent you with a link to check out the newest version of the website, www.theonion.com.	If you didn't get the e-mail I just sent you with a link in it check out the latest www.theonion.com cd
Chris wondered who would take the time to figure that out.	That is weird. Who would take the time to figure that out? Chris
They should notify of any help needed.	Pls migrate and notify of any help needed. Daniel (281-541-6203)
I don't think I will be able to make it, but be sure to say hi to Jen, take care, and look forward to the wedding.	Matt, Looking forward to the wedding. Unfortunately, I don't think I will be able to make it August long weekend but say high to Johnny and think of me. Take care and be sure to say hi to Jen. Chris
Chris Dorland, I need trade access to the USD Currency products.	Stephanie, I need trade access to the USD Currency products on EOL. ADM46075 Thanx Chris Dorland
Chris, I haven't received the tickets yet, but they are on their way.	I haven't received the tickets yet but they are on the way. Thanx, Chris
Buy Gas Producers the AGA just came out, it's crazy bullish gas.	Buy Gas Producers the AGA just came out and it was Crazy bullish gas
I was told by Gaffney to ask you about your dance partmer.	Gaffney told me to ask you about your dance partmer?
I need to book the computer training room for a meeting on Wednesday, can you make that happen?	Carla, I need to book the computer training room for a meeting Wednesday at 3:30. Can you make that happen? Let me know. Chris
You can get on internal MSN.	Get on internal MSN IM Mullett
Dorland the loudmouth is back in the town after being gone for a long time.	So much for keeping it quiet. Dorland the loudmouth is back in town.
Thanks, that is what I will say.	Thanx
It's very difficult to be short now since that number is unbelievable.	Holy AGA batman! That number is unbelievable. Tough to be short now. Keving Presto was short the aga swap at 50 for $60 / bcf.
I don't see a new March Aeco product set up, give me a call.	Dianne, There doesn't seem to be a new March Aeco product set up. Give me a call. Chris
I don't care if you don't like the new Janet song. I'm funny. My life is being turned upside down by work.	It doesn't really matter if you don't like the new Janet song. I'm so funny. My life is being turned upside down by work but I can't be much more specific than that.
Please, I need that receipt and photocopied document as soon as possible.	I need that receipt and photocopy asap please.
I will deliver the card in person about 10 days from now.	Happy Anniversary! I will deliver the card in person in about 10 days. Chris
I want to use the computer training room to display my spreadsheet, but I can't do it on the computer. I would appreciate it if you could set up the room so I can use it.	Could you please set up the computer training room so I can log on and display a spreadsheet on the screen. We are having a meeting at 3:30. Thank you Chris
I need a copy of the check and a receipt for the RRSP contribution I sent to you.	Did you get the RRSP contribution I sent? I need you to make a copy of the check and send me that and a receipt. Thanx Chris
I'm coming to Houston on Wednesday and Thursday to sit at the East desk, should you please let them know I'm coming?	John, I am planning to come to Houston Wednesday and Thursday to sit with the East desk. Unless that is going to create problems, would you mind letting them know that I'm coming. Chris
Chris, thanks for letting me know that I made it.	I made it. Thanx Chris
You need a lot more than the 32 MB mine has.	Mine has 32 MB. You need way more that that. You can buy memory cards for most players. Check out www.riohome.com Chris
What is this stuff?	What is this stuff? Chris
Ryan is testing the forwarding system with Chris Dorland.	Ryan Testing the Ivey e-mail forwarding system. If you get this w/b. Chris Dorland
What phone number are you using for your job?	What is your work phone number?
I have the internet as well.	thanx I have the internet too
No, that's not true.	NO
It's thanx.	thanx
Chris Dorland wrote to tell me that I needed to change my phone number on the website.	Stephanie My phone number needs to be changed on the web site. My new number is 403-974-6910. Thanx Chris Dorland
I have Jan's information, for you to please email me at jwilson@sempratrading.com	Teri thanx for Al's address. I have Jan's info. for you p. 416-205-4542 jwilson@sempratrading.com
Do you have a number for customer service? I want to get rid of my account but I don't know how to get in touch with them.	Do you have a number for MSN customer service? I want to cancel my MSN account but have no idea how to get in touch with them. Chris
Why don't you answer your phone?	how come you never answer your phone????
Chris, I'm wondering if you have a number I can call?	Tricia, I was wondering how I get set up with shaw cable internet access. Do you have a number I can call? Chris
Chris, do you know anything about my US refund?	Judy, Any word on my US refund? Chris
Chris Papousek is the credit contact at TXU.	John, The credit contact at TXU is Chris Papousek 713-210-5085. Thanx, Chris
I think I have a small plate of food in there.	I think I have a lasagna in there. You can have it. cd
Chris asked Dora why she would do this through natsource and pay brokerage.	Dora, Why would you do this through natsource and pay brokerage? Chris
I'm keeping those suggestions on file. I'm hoping it will help him relax a bit.	Thanx I'll keep those suggestions on file. I got him a pretty cool hammock from this Sharper Image type place. Hopefully it will help him relax a little. Chris
Task Start Date: 2 Task Due On: Tazewell Accountancy Task priority is 2 Task Due On: Tazewell Accountancy Task start date is 2 Task Due On: Tazewell Accountancy Task start date is 2	TASK ASSIGNMENT Task Priority: 2 Task Due On: Task Start Date:
Hopefully, I will be able to find a date.	I'm in and hopefully I can even find a date. Chris
Thanks for the concern, Chris.	Made it safely. Thanx for the concern. Take care, Chris
I'll help Bugg move them.	I'll give them to Bugg. I will help move. Chris
Please let us know how Dina is doing, when she has the baby.	John, How is Dina doing? Be sure to let us know when she has the baby/ Chris
Alan Wright isn't too sure about this one, but he does know that PanCanadian Petroleum, Transcanada Gas Services, Brian Krumpka, and Toby McKenna are all from Canada.	Pancanadian Petroleum - Wayne Harvey Transcanada Gas Services - Brian Krumpka Engage Energy Canada - Toby McKenna Canadian Imperial Bank of Commerce - Alan Wright (not too sure about this one)
Chris asked if there was a word on his expense.	Any word on my expense $? Chris
I just wanted to know if there would be incentives on 2002's.	How about 2002's? I was just thinking there would be incentives on 2001's. Chris
I will give you a shout later.	Thanx I'll give you a shout later.
There is no problem.	No problem.
Do you want to meet me at my place around 6:30 pm because I think I'm going to go home early?	Hey! I think I am going to go home early so do you want to meet at my place around 6:30? Chris
It is very good, but I am not on it.	I'm not on either. It is good upside down. I am crazy busy. Did you get the "Doesn't really matter.." bit. I am so funny.
I am moving to Houston in order to trade power in the Northeastern US.	Mustafa I finally found Nav. nrahemtulla@thecampus.com I am moving to Houston to trade power in the Northeastern US. Gotta hop, Chris
30K	30K
I'll call you later, I might be moving back to Cow town.	I might be moving back to Cow town. I'll call you later...
Just dropped a note to say hi, will write more soon.	Jill, Just dropping a note to say hi! Will write more soon. Chris
Kathy, can you run a report on the first and third levels of the game for our book?	Kathy, Could you run a NX1 / NX3 report for our book. Thanx, Chris
Do you use msn messenger?	Are you on msn messenger?
Hopefully we will get another Britney strip tease this year at the MTV music awards.	MTV music awards Thursday September 6th - Hopefully we get another Britney strip tease this year.
Did you send a card to him?	Did you send Amanda a card?
I can give you a call if you want to meet at 11:30 or 12.	Paul How about meeting at 11:30 or 12? I am in the office so give me a call. CD 3-1663
Chris, thank you.	Thanx Chris
It's pretty close to where you're at, isn't it?	Where is you place? It is pretty close to there isn't it.
Dad, Canadian 88 was up 0.25 to $2.05.	Dad, Canadian 88 up $0.25 to $2.05
I came to check out that girl but didn't see her.	I came to check out that girl and I didn't see her. Chris
The kid is moving back to cow town and I'll be in town next week looking for a place to live.	Actually lots. Keep this on the QT for now but this kid is moving back to cow town. I'll be in town next week shopping for somewhere to live. Just in time for ski season. Later Chris
What did the pattened move do?	How did the pattened move work? cd
Can't do it because I'm too busy.	can't do it...way too busy
I'm trying to find a parking spot, but I can't seem to locate the address of the HR website where I can see my old pay stubs.	Kim, What is the address of the HR website where I can see my old pay stubs? I'm trying to sort out my parking situation. Thanx Chris
Kim, do you think I'm worried that I haven't booked a moving company yet?	Kim, Should I be worried that I haven't book movers yet? Chris
I just sold half of my ENE's.	Just sold half my ENE's.
I lay low this weekend because I had a cold, but my friend had a good time.	How was your final stampede weekend? I have a cold so I layed pretty low this weekend. Did your friend have a good time? w/b cd
Chris Dorland, I'd like to move to the garage at the Enron Center.	I would like to move to the Enron Center garage. Thank you, Chris Dorland 713-853-1633
I need you to suspend my PAC payments until I can let you know when they're going to start again.	Brad, Could you suspend my PAC payments to Mackenzie for my investment (not RRSP account) until I let you know to start them again. Thanx, Chris
39.40 is the amount of transactions that are reported to the Securities and Exchange Commission.	39.40 TRADES ENE
Is it a problem that there are just Laird, Blair, Blair, and a couple of other guys around here?	Just Laird, Blair, Perry, Tony and a couple of guys around here. Is that a problem?
I talked to Brad and he said he would prefer to go to Red Deer.	Dan, I talked to Brad. He said that he would prefer to go out in Red Deer. Chris
I have a minature goat and I am not concerned about making a housing decision in one day.	I already have a minature goat. I am a little concerned about making a housing decision in one day but what the fuck.
I think that's my grandma Ivie.	Great story. I think that was my Grandma Ivie.
All payroll deductions to non-registered accounts in my name will be stopped until further notice.	Please stop all payroll deductions to registered and non-registered accounts in my name untill further notice.
Chris knows how to make easy money.	Look at ENE 48.75. Easy money. Chris
I'll be sure to pick up my lamp from the cleaners.	I'll be sure to go get my lampshade from the cleaners...
Is it possible that the change will keep me from losing 30% again this year?	Chris Dorland 401-3511 14a St. SW Calgary, AB T2T 3Y1 403-214-0454 Are these change meant to keep me from losing 30% again this year? Chris
When I spoke with her, she said that it was a very good estimate for my move and that I would have to pay $5000USD for it.	Judi, Did you receive a quote for Williams yet? When I spoke with Terri she said that $5000 USD was a pretty good estimate for my move. Chris
I would like a conference room for you on Thursday, September 6th at 10am.	Angela, Could you book a conference room for me on Thursday September 6th at 10am for about an hour. Any room is fine. Thanx Chris Dorland
I'll call you later to talk about it.	I'll give you a call later to discuss...
Can you give me some information about what I need to take care of it over the weekend?	What do you need from me to transfer my RRSP and Penson. I want to take care of it weekend. Chris
I have transferred to Canada and would appreciate it if you could forward it to me here.	I have transferred to Enron Canada (Calgary). Please forward it to me here. Thanx Chris Dorland 403-974-6701
The lady in the HR department said Charlotte is on maternity leave and I want you to find out who else we can call.	Brad The lady in our HR department told me Charlotte is out on maternity leave. Do you want me to find out who else we can call? Chris
Where do you get this stuff?	That was very nice. Where do you get this stuff? Chris
I am getting parking deducted from my pay check and I don't know who to call to get it straightened out.	Kim, I am getting parking deducted twice from my pay check. Who do I contact to straighten that out? Thanx Chris
I need some songs after buying an mp3 player. I know you are the man and want to hook me up.	I bought an MP3 player and need some songs. I understand you are the man. Hook me up! Chris
Chris, what is the password and login ID for this site?	Angela, What is our password and login ID for this site? Chris
Call me when I'm at work.	Call me at work. Chris
Let me know if there are any fundamental problems with this model.	If you find any fundamental problems with this model let me know.
Sorry, but it was a gong show around here.	Sorry, it has been a gong show around here. I'll write back soon. Chris
I need to add some products but I'm having trouble with the EOL customer ID. Can you clear the pages on my EOL customer ID?	Jay, Could you clear the composite pages on my EOL customer ID. I need to add some products and I am having some trouble. My ID is ADM08892. Thanx, Chris Dorland
There are five toes on a foot.	5 toes on a foot
If you're bored, ask your tire guy what he thinks of the Winter Sport M2 tires.	If you are bored try to find out what your tire guy thinks of Dunlop Winter Sport M2 tires. Is you tire guy also a wheel guy? I need some winter wheels as well.
I've been transferred to Houston, Texas. Could you please remove me from the distribution list?	Laurel, I have been transferred to Houston, TX. Could you please take me off the Calgary distribution list. Thank you, Chris Dorland
Ian, forget that last one. I just updated my e-mail.	Ian, Forget that last message. Apparently my e-mail just updated. Thanx Chris
It's insane that I have to go get my rain hair and red shoes as well as return to the clown show.	POWER IS JUST AS CRAZY I HAVE TO GO PUT ON MY RAINBOW WIG AND RED SHOES AND GET BACK TO THE CLOWN SHOW! CD
Task start date is the most important task priority of the Sackment Task.	TASK ASSIGNMENT Task Priority: 1 Task Due On: Task Start Date:
I'm going to Red Deer this weekend for Mother's Day and my brother's B-Day, but I will catch you next week.	That is fine ... I'm off to Red Deer this weekend for Mother's Day and my brother's B-Day but I'll catch you next week. Beautiful day in downtown Calgary. Chris
The market is 36 at 38 for tommorow's close.	The market here for tommorow's close is 36 at 38.
That is off the list of possibilities, but I heard from a friend that Kerrie Murray got engaged recently.	I just heard from a mutual friend that Kerrie Murray got engaged recently. Scratch that one off the list of possibles.
Today was a bad day, with the temperature in the Northeast coming in 10 degrees hotter than we thought.	Want to hear about a bad day. Down $2 million USD today. Temps came in 10 degress hotter than we thought in the Northeast this week and blew up! Chris
I am a Canadian citizen and have no need for immigration assistance as I am now working in Canada.	I no longer require help with immigration as I am working in Canada now and I am a Canadian citizen.
Are we able to talk on Saturday night?	Are you coming over on Saturday night? We can talk then. Chris
I'll talk to the guy in Houston to make sure he's up to date with what's going on.	Mike, Can you light a fire under the phone guys in Houston to look into fixing our line. I'll talk to our guy and get his gas in gear. Chris
We are going to have a good time at the Lez bar.	We're going to have some fun at the Lez bar!
If you sent my visa documents, I will come back today, even though I will be out of the office.	Margaret, I was wondering if you sent my visa documents yesterday or today. I will be out of the office this afternoon but I would come back if my visa documents are going to me here. Thanx, Chris
Thank you cd.	Thanx cd
I just canceled a $500/month PAC that I had set up, and it has to be more than that.	$700 ? It has to be more than that. I had a $500/month PAC set up that I just cancelled in April.
It is completely loaded with 6K options on the base model.	On the base model. Mine has 6K in options. It is totally loaded. Silver/Black with 3800 miles.
There is a Bastard.	Bastard
Chris, thanks for your help.	Thanx for your help. Chris
Chris, do you know what my mail stop is? This person has some mail but it doesn't seem to be finding me.	TJae Do you know what my mail stop # is? This person has some mail that doesn't seem to be finding me. Thanx Chris
Fed Ex is going to deliver it to the office today, but Carol, they missed me on Saturday.	Carol, Fed Ex missed me on Saturday but are going to deliver it to the office today (hopefully). Thanx, Chris
I'm moving to Canada to trade gas and I would really like to get your daily technical sheet, Anna, I'm wondering if you can send it to me or if I should post it on the commodity fundy's site.	Anna, I am moving back to Canada to trade gas but I would really like to get your daily technical sheet. Could you e-mail it to me or perhaps start posting it on the commodity fundy's site? Thanx Chris
We want to run a June NX3/NX1 for our book.	Will you please run a June NX3/NX1 for our book.
I don't go to movies on Tuesdays. You are going out wednesday and I leave for Ft. Mac on Thursday.	I want to go see the klumps. How is tonight? I don't go to movies on tuesdays. You are going out wednesday and I leave for Ft. Mac on thursday.
Can you please make sure that I have full access to the site?	Chris, I am having trouble accessing the in-house 6-10 day weather comparison on the fundy's site. Can you make sure I have access to the whole site? Thanx Chris Dorland
Please add me to the distribution list for the weekend weather update, Chris.Dorland@enron.com	Jose, Could you please add me to the distribution list for the weekend weather update. Thanx Chris Chris.Dorland@enron.com
The bonus structure was lined out in detail in the video conferences we had with Houston and it was 10X better than enrons.	The bonus structure was lined out in detail in a couple of HR video conferences we had with Houston. It is about 10X better than enrons.
Can't get away on Monday, so go see you Saturday night.	Can't get away on Monday. See you Saturday night. Chris
Did your friends not know why you invited the paper boy to your party?	Thanx for the heads up. Did your friends wonder why you had invited the paper boy to your party?
How is your week going? I feel like I have to eat raw fish and red deer in order to stay healthy.	KERRIE, WHAT'S UP? HOW IS YOUR WEEK SHAPING UP? I FEEL THE NEED TO EAT RAW FISH AND MOCK RED DEER PEOPLE. W/B CHRIS
If you have time this afternoon, I'd like to chat with you.	Jon, If you have a chance this afternoon I'd like to chat to you for a minute. Chris
On 8th of August, at 5pm, what about earl's?	how about earl's (how original) on 8th ave. at 5pm?
The mailing address for me is 5151 Edloe St.	My mailing address. 5151 Edloe St. #14306 Houston, Texas 77005 713-588-5131
I don't think it's too late to leave on the deal, did you know that Blair lived there?	I didn't know Blair lived up there. Do you think it's too late to flake on the deal?
It's a little something to get you up in the morning.	Just a little something to brighten up your weekend!
You need to log in to msn. Chris, you need to, you need to log in to msn.	Ryan, You need to log onto msn IM. Chris
It's a good idea to avoid fried and starchy foods.	Try to stay away from fried and starchy foods. I'm trying to watch my figure.
I don't know what it is, or whether it's thanx or not.	thanx
The range on my next day was between 130 and 260 kilowatts.	The range on my next day power was 110 to 260.
We will go out on Friday night, and we were thinking about going to earl's and hitting the town. Chris, how is your day going?	I talked to the boys and we are going to go out on Friday night. We were thinking of going to earl's and then hitting the town. What do you think? Chris (PS How is your day going?)
What if there were changes made to the Grand Cherokee in 2002?	What if any changes were made to the Grand Cherokee Limited for 2002?
Have you moved to the wonderful world of boxes with Enron Canada yet?	Have you guys moved over to the wonderful world of boxes with Enron Canada yet?
The water pump is going to cost $700 and I told them to fix it.	Varsity called and the water pump needs to be replaced. It is going to be $700. I told them to go ahead and fix it. Hope that's OK. Chris
Get the shit kicked out of it by checking out MSFT.	Check out MSFT. Getting the shit kicked out of it.
Send me your info, I'm updating my palm pilot.	I'm updating my palm pilot send your info. cd
I leave by 5 every day except for Wednesday, when I leave by 6.	Today I'm leaving by 5. Usually by 5:30-6. Et vous?
The article explains what Enron does on a macro level, and I have to say that I think it does a very good job.	Dad, This article does a very good job of explaining what Enron does on a macro level. Check it out! Chris www.fortune.com/fortune/fortune500/enr.html
I can't get myself back on the trail. I will try to find someone who looks like Britney Spears.	No chance of me getting back on the cougar trail. I have devoted myself to scouting out dumb blondes under the age of 25. Ideally I will find some 22 year old Britney Spears look alike. Wish me well. Chris
Chris, I'm missing info. T2T 3Y1 403-214-0454.	Tricia, Here is my missing info. T2T 3Y1 403-214-0454 Thanx Chris
Chris Dorland is my mail stop.	My mail stop is EB 3125A Chris Dorland
You should be able to give the reversals for this month.	When you have them ready could you give me the reversals for this month please. Thanx Chris
I have a number of questions about the difference between the 401(k) plan and the savings plan.	Some of my questions. What is the difference between the 401K plan and savings plan? How much does Enron contribute / match for each plan? What is the max. annual 401k contribution? Thanx, Chris
What is the dance partner?	Dance partner?
Chris, I was going to come down and talk to you this afternoon but I have been so crazy, they were going to deduct me for parking 9 and 11.	Louis Thank you! I have been really crazy and was going to come down and talk to you this afternoon. They were deducting me for parking 9 and parking 11. Thanx again, Chris Dorland
I hope you're getting some rest over the last couple of days, I can't imagine how dark you are.	Hello, I can't imagine how dark you guys are. Hope you are soaking up your last couple of days. Have a cubra libra for me! Love Chris
I was thinking of going to the deer on Friday and then going to calgary on Saturday, please let me know what you think.	Mikey, Dan is going to come to town this weekend. I was thinking of going to the deer on friday and then going out in Calgary saturday night. Let me know what you think. Chris
I need to speak to John about the changes he will be affected by.	Please don't change any deals until we have spoken. I need to talk to John about how these changes will affect his positions. Chris
Is it five years out of a particular date?	Five years out of any particular date?
Do you know of a way I can get my name taken off of the Brad Galante email list?	Willis, Can you do me a favor and get my name taken off the Brad Galante e-mail list for plant outages? Thanx Chris
I have 4 tickets for Friday, but I don't know if they're good or bad, but they're free.	I have 4 tickets for Friday. I don't know if they are good, bad or what but they are free. Talk to you later. Chris
I got a tee time at 12:24 on Sunday.	I got a tee time for 12:24 on Sunday. Chris
Drewlo's clothes need to be checked for paint thinner.	Somebody should check Drewlo's clothes for paint thinner. CD
I have one that is $500 per month, and it is running for my RRSP account.	I do have one running for my RRSP account. $500 per month. I was wrong about my unregistered account. Chris
Chris Dorland, I would like to go to your office and get my Visa documents.	Margaret, How do I get to your office? I would like to come by and get my Visa documents. Thanx, Chris Dorland 713-853-1663
I don't want to miss out on the customers and so I need to do a lot of other things.	I can't just sit here and write e-mails all day. I'm a busy man. I did not mean to offend you. I had smoozing to do and didn't want to neglect our customers.
I forgot about you, Chris!	Sorry, I forgot about you! Chris
Fuck you. That's how we say it in Belgium.	Fuck you. That's how we spell it in Belgium.
I will let you know when I get a car, Megan, but I haven't bought one yet.	Megan, I haven't bought a car yet but I will let you know when I get one. When do we get the stalls in E&Y? Chris
Ryan Watt wants to eat sushi tonight.	Sushi tonight? Ryan Watt says high. Chris
I'd like to know if I have received any restricted stock or options since May 1, 1997 when I started with Enron.	I started with Enron May 1, 1997. I would like to know all options and restricted stock I have received since then. Thanx Chris
Please ensure someone knows how to update the PJM daily sheet while you are out.	Ricardo, Please make sure someone knows how to update the PJM daily sheet while you are out? Thanx, Chris
I'll call John Z this afternoon to see if I can come to the off site with the west guys.	I think a mid sept tee time will work. I want to try to be there for the off site with the west guys. Tell John Z I'll call him this afternoon. Chris
Chris, don't forget to cancel that political action committee for me, talk to you later.	Don't forget to cancel that PAC for me? Talk to you later. Chris
I need to change the amount to about 125-150kUSD.	Thanx Laura. I need to change about 125-150k USD is that OK. Chris
We are not going to cook for Jan., but I will get back to you with more information.	Grigs, As far as I know we not planning on deliviering for Jan. I will ask Cowan and Peggy and get back to you. Chris PS Hope you had a good Christmas!
I have to get the money for you by this weekend.	What date do I need to get you the money by? I am going to Red Deer this weekend. Chris
It's time to call stephanie severe.	you should call stephanie severe
I'm going to send you a fishing cartoon.	Send me your e-mail address at home. I want to send you that fishing cartoon. Chris
I have a health insurance and a drug card but I don't have a dental card.	I have received my health insurance and perscription drug card but not my dental card. Hopefully today my mail will find me. Chris Dorland
It's too bad that I'm going back to calgary on the 26th.	Too bad. Going back to calgary on the 26th.
Are you still looking for an analyst? Should I send the resume to Dawn?	Are you guys still looking for an analyst? Should I send the resume to Dawn or you directly? Chris
Kim, I want to know what will happen to my savings and 401(k) when I go back to my hometown of CALGARY.	Kim, Any word on what happens to my 401k and/or savings plan when I transfer back to Calgary? Let me know. Thanx, Chris
I bought it today and it is going to be brought in for me by Lavo.	Lavo is going to bring it in for me. I bought QQQ today at 93. Traded 102 in afterhours trading on the island. Enron is free. Chris
Chris, thank you.	Thanx Chris
Does anyone know if there is any risk for the month of July?	Kathy, Do we have any NX1 / NX3 risk for July? Chris
I'm not sure if I'm going to buy 16" or 17" wheels for the winter.	Lexus IS 300. Not sure if I am going to buy 17" or 16" wheels for the winter. Jackass.
Chris Dorland just bought a vehicle, thank you for your attention, but he already bought a vehicle.	Thanks for your attention but I already bought a vehicle. Chris Dorland
Can you tell me about the E-mail addresses for Mike Krueger?	BUGG, DO YOU HAVE AN E-MAIL ADDRESS FOR MIKE KRUEGER? DORLAND
I sent you a package today, I will fax copies of my diplomas as soon as I receive them.	I sent you a package by FEDEX today. I will fax copies of my diploma and transcripts as soon as I recieve them. Thanx, Chris
You should ask an IT guy to set up msn messenger for you.	You need to get set up on msn messenger. I takes 2 seconds. Ask an IT guy.
It is pouring rain and 9 degrees here. Keep it real. Did you get everything straightened out?	How goes day #1 in TO? Did you get everything straightened out with the movers? It is pouring rain and 9 celcius here. Keep it real. Chris
I believe we should give him a card and let him know that his present will be there when my furniture arrives.	I think we should get him a card and tell him his present will be there when my furniture gets there.
You must sign in to be able to use MSN Messenger.	Sign in to MSN Messenger....
I think I'll be in the city of calgary.	Thanx I think I will be in Calgary
I will probably have a little room, but below 28K I'll probably just move it back to CALGARY.	I'll probably have a little room but below 28K I'll probably just move it back to Calgary. Let me know if you want to see it. I car pool with Benson so I only have it here every other day.
GS is a place to be if you're going to trade debt or equity.	What is the specific appeal of distressed debt? If you are going to trade debt or equities GS is the place to be.
My world is being turned upside down and I haven't written back yet, but it is amazing how much your life can change in a day.	Where do you get this stuff? Sorry I haven't written back but my world is being turned upside down. It is amazing how much your life can change in a day. more to follow...
I need 4 tickets for Friday's Astros game. If you have any that you know of, please let me know.	Tych, I'm looking for 4 tickets for Friday's Astros game. If you stumble upon any let me know. Thanx Chris
I spoke with Mike Swerzbin and he told me that I should get access to your website.	Tim, I spoke with Mike Swerzbin earlier today and he suggested that I get access to your web site. If you could set me up that would be great. Also if you could send me the URL. Thanx Chris
Dan and Chris, you have tickets to see the Dixie Chicks on June 4.	Dan, I have 4 tickets to the Dixie Chicks for Sunday June 4. Chris
I was wearing them all weekend, but I don't know anything about sunglasses.	I don't know anything about any sunglasses. Just kidding, I was wearing them all weekend. Chris
I wanted to let you know that I sent you the package on wednesday.	Just wanted to confirm you received the package I sent you on wednesday. Chirs Dorland 403-974-6910
This is a sample of what an analyst would have in his personal directory.	This is an example of what one analyst sent me for his personal directory
It was written.	elequently written
You have it.	You got it.
I just wanted to let you know that I sent you the package that I left on your desk.	Carla, Just wanted to confirm that you sent the package I left on your desk. Let me know. Thanx, Chris
Anne, I didn't get my USER ID for PEP, do you know how to get it?	Anne, I didn't receive my USER ID for PEP. Do you know how I get it? Chris
I hope I will hear from the moving company this afternoon.	Everything seems OK. Hopefully I will hear from the mover's this afternoon. Thanx, Chris
Thank you for taking the time to say thank you.	thank you
It's going to be a call from Paul tonight.	Done! Expect a call from Paul tonight. Chris
Chris Dorland can be reached at 5151 Edloe Street in Houston, Texas 77005 or by phone at (713) 588-5131.	Chris Dorland 5151 Edloe St. #14306 Houston, TX 77005 (713)-588-5131 Thanx Chris (P.S. I haven't received my pay stub for this pay period)
I left early yesterday and I'm wondering if it will work for you tonight.	Martin, I left early yesterday. Does tonight work for you? No spoiler and the car was high and dry during Allison. Chris
I want to know if our plan is administered by a company. I need to get in touch with someone in order to roll into the IRA.	Is our 401K plan administered by Paine Webber? If not, who? Just wondering who I need to contact in order to roll into and IRA. Thanx Chris
The Simon Kwont Tiffany and Co. is located at 85 Bloor St. in West Toronto, Ontario, M5S 1M1.	Simon Kwont Tiffany & Co. 85 Bloor St. West Toronto, ON M5S 1M1 416-921-3900
Rob and I will be playing golf on Sunday.	John, Rob and I are both in for golf on Sunday. Chris
I wanted to keep you in the loop, so I sent all of my Visa application information to Margaret.	Kim, I sent all of my Visa application information to Margaret by FedEx today. Just thought I would keep you in the loop! Chris
It is a Grand Cherokee with a V8 loaded and 55 000 km's.	It is a 1997 Grand Cherokee Laredo, 55 000 km's, V8 loaded. I think it is worth about $25 Grand. Thanx Chris
After a year in my in box, I thought I would try out the Alumninet package.	Nav, Opened my Ivey Alumninet package after about a year in my in box and thought I would try it out. If this gets to you w/b. Chris Dorland
I've been long the Sept-Oct NX1 spread about 250 times.	I am long the Sept-Oct NX1 spread about 250 times. I love that trade. Rack up another half million for me today. Fuck!
Chris, I don't need that user.	I don't need that user. Thanx Chris
Crystal, Scott is off to Dallas for the weekend, but I'll be able to check out a game on Friday. I'll try to find some Enron tickets.	Crystal, Scott is off to Dallas for the weekend but I think I can swing checking out a game on Friday. How many people? I'll try to find some Enron tickets. Let me know... Chris
I would like to know how to use my brother's e-mail.	Could you teach my brother how to use his e-mail? Thanx Dorland
I've said it before, Thanx.	Thanx
The gift that doesn't stop is the power.	How about TD bank. The gift that keeps on giving. Power still weak.
I was wondering if you talked to MH? w/b Chris.	Movie tonight? Did you talk to MH? w/b Chris
Dad, what rules are in place for guests on the weekend?	Dad, What is the rule for guests on the weekend? Chris
Chris is correct that they are wrong.	They are wrong. Chris
I have the golden touch so I was wondering if you bought any.	Did you buy any ? I have the golden touch. 500 at 37
This is something that I would like to check out.	Check this out!
Lady with a python on one side and Star wars on the other.	Lady with python on one side , Star wars on the other...
Thanx a lot.	Thanx
I think that's enough vol. for me, since Nov-Mar Sumas moved about 0.20 since I started watching it.	Nov-Mar Sumas has moved about 0.20 since I started watching it. I guess that's enough vol. for me. Chris
No time off has been taken by me.	I have taken no time off...
Is there anything I need to do with my RRSP contributions this year?	How about my RRSP contributions for this year? Chris
When you get a minute, please come see me because there is some confusion regarding yesterday's premstar deal.	Ryan, There is some confusion regarding the premstar deal from yesterday. Could you come see me when you get a minute. Chris
Is that Chris?	thanx chris
Chris, I received my transcripts from the University today and I am going to send them by FedEx.	Margaret, I received my transcripts from University today. I will send them by FedEx. Chris
Is there a black one in stock, what color it is in the interior?	Do you have a black one in stock? If so, what color interior? Chris
I hate it when that happens. How is your week going? I'm half way there.	Very nice! I hate it when that happens. How is you week going? Mine has been pretty crazy but we're half way there. Talk to you later... Chris
Do you think there's a chance of us talking about 403-343-0911?	403-343-0911?
Can you tell me how I can change my profile so I can manage physical product on eol?	Claudia, I can't manage physical product on eol (stack manager). Can you change my profile so that I can? Thanx Chris Dorland (eg. Nov-Mar Physical Huntington Index))
If there is room for Brad, I won't call him.	If there is room for Brad I won't bother calling Darren. Chris
Duke Energy injected 50 million of cash into Canadian 88.	Dad, Apparently Duke Energy injected 50 Million of cash into Canadian 88. Greg Novall has been replaced as President and CEO. Chris
Chris asked about the word on golf this weekend.	What is the word on golf this weekend? Chris
You can purchase Independence Day on DVD.	Go buy Independence Day on DVD.
Sept.20 is when I get possesion.	I get possesion Sept.20
What is the symbol on Rio Alto?	What is the symbol on Rio Alto?
I didn't receive a call but I did fill out an accomplishment sheet for Barry Tycholiz.	Terry, I didn't receive any call (I may have accidentally deleted it) but I filled out an accomplishment sheet for Barry Tycholiz yesterday. Thanx, Chris
They aren't getting that until I get mine, and I'm going to owe them $ in April.	Thanx for the update. I'm going to owe them $ in April and they aren't getting that untill I get mine. Chris
Do you plan to go to TO?	Nice Are you going to TO?
What was cottage country like?	How was cottage country?
Chris received the Forest Green Jeep Grand Cherokee Laredo License.	Forest Green Jeep Grand Cherokee Laredo License - MKV 835 Thanx, Chris
I think someone in Canada is using my identity, but I am not using CQG.	I am not using CQG but I think someone in Canada is using my ID Chris
Jean would love to have you as a gift.	Jean Cummings 283-7561 Get Kerri a gift.
Gowans called me last night to tell me about her boyfriend and I need to get in touch with you.	Mikey, You checking this e-mail yet. Gowans called me last night and I got to hear all about how great her boyfriend is. Drop me a line. Chris
That's cool, I think it will be done financially with us and we will take care of the buying of the drugs in the market.	Fun That's cool. I think AEC is going to do it financially with us and take care of buying the phys in the market. Did you get 80 million? Chris
The stock market has risen more than you've ever bought in your life.	Stock market is exploding. Dow 11133 (up 260). Nasdaq 2150 (up 60). It has to be higher than where you bought now? Chris
There is a report that says Brunner Island is back on, but our sheet doesn't show it coming back until November 3.	Ricardo, This consultant report has Brunner Island back on. Our sheet doesn't have it coming back untill Nov.3. Which is correct? Chris
Chris, please give me a call.	Mike, Give me a call. 403-974-6910 Chris
Adding products to our pages everyday would be more convenient.	Not having to add products (ie. Hub cash) to our composite pages everyday would be more convenient.
I want to know if you have the phone numbers for these guys.	Do you have the phone numbers for these guys? Thanx Chris
Chris Dorland would like to sign up for the sprint broadband direct but it is not included on the click at home website.	I would like to sign up for the sprint broadband direct but it isn't a selection on the click at home website. Please inform. Chris Dorland 3-1663
I am very happy with it, it is better than the 3 series, it is dark tint on the windows, it is killer 17's.	Yes IS 300 Silver/Black - dark tint on the windows, killer 17's I am very happy with it. I like it better than the 3 series. cd
If you are not on AIM, then I can't give you witty remarks.	I can't bomard you with witty remarks if you aren't on IM
I'd like to know my statistics... Send me your numbers...	Send me stats...
The company getting worked on.	Enron getting worked!!!!!!!!!!!!!!!!!!!!!!!!!!!!!!!!
Thank you!	Thanx!
It's great that we were discussing going to other floors because our bathroom is such a dump.	That is great. We were just having a discussion about going to other floors to take a shit because our bathroom is such a dump.
Chris hopes Dina and the baby are doing well.	Hope Dina and the baby are doing well. Chris
Nella has a master list of all Canadian software.	Nella Cappaletto has a master list of all Canadian software and applications. Chris
I want to make sure we have all of the hedges in the book. I just want to make sure we aren't missing any deals.	Kathy, Could you run a report that lists all of the FX hedges in our book. I just want to make sure we aren't missing any deals in our model. Thanx, Chris
Anderson looks good.	Anderson looks pretty good.
I think I will add to my position on the Sept/Oct Spread.	Things are look up on the Sept/Oct. Spread I think I am going to add to my position. Cash going out week. Chris
I was checking out the whiskey on Saturday. It is a really cool club, but the no under 25 age limit takes away from the talent pool.	Checked out the whiskey on Saturday. It is a really cool club but the no under 25 takes away from the talent pool. You still coming to town next weekend? Let me know. Chris
Peters and Co. should not be made to wait.	You should reply ASAP. Don't make Peters and Co. wait. Chris
I want to know who to contact to get signed up for my 401(k) package, I haven't received it yet.	I still haven't received a 401K package. Who should I contact to get signed up? Let me know. Thanx, Chris
Please tell me as soon as possible.	PLEASE ADVISE ASAP
Chris, I need to know who to talk to about setting up the 401(k) plan.	Jennifer, I am anxious to get set up on the 401K plan. Who do I need to talk to? Thanx, Chris
I'm taking my lamp to the cleaners and Meg, I can't wait to go to the cabin party.	Meg, Can't wait for the cabin party. Taking my lampshade to the cleaners after work. Chris
What's happening in Cow town, Hawker? Are you playing cards? Didn't go so well.	Hawker, What's going on? How are things in Cow town? You trading a book yet? Playing any poker? Bingham was here for Q-School last week. Didn't go so well. Cd
Dianne, do you know when our index positions will be ready?	Dianne, Do you have our index positions for September ready yet? Thanx, Chris
I just want to make a copy of it.	I just want to print this off.
Chris started May 5, 1997.	Tricia Not that I'm counting but I started May 5, 1997. Chris
Dawn, I paid my Y membership with my Visa but I'm not sure if I'll get my $1000 back.	Dawn, I want to allocate my $1000 of flex money to my YMCA membership. I paid for the Y membership with my Visa. How do I get my $1000 back? Thanx, Chris
Chris asked if he had gotten his message about his parking tag.	Dad, Did you get my message about my parking tag? Chris
I ate at bell's cafe yesterday and it's on 14a st.	I had lunch at bell's cafe yesterday. They are the red brick townhouses on 14a st. Moving back Sept. 15.
All the news I've read is very good, you're on crack, I've read all the news.	What press? All the news I've read is great. You're on crack.
When will you be here?	When are you coming? cd
The apartment I was given was the wrong address in Dawn's e-mail.	Dawn got my apartment # wrong in her e-mail. This is my correct address. 408 100 10a St. NW Calgary, AB T2N 4T3 Thanx, Chris
Chris, if that helps you, it'd be next to Keith Holst.	Next to Keith Holst if that helps. Thanx Chris
I would like to know if you can send this data to her.	Can you please send her this data? Thanx Chris
Please don't forget to tee times for Saturday and Sunday, as Ryan won't be able to make it untill then.	Dad, Please don't forget to make tee times for Saturday and Sunday. I was thinking around noon Saturday and around 4pm on Sunday (Ryan can't make it untill then). Thanx, Chris
Chris Dorland has no idea what his password is for the system.	I don't know what my user name an password are for the system. Chris Dorland
Thanks for your help, Anne, can you tell me the location of the file with the descriptions?	Peggy Could you send the location of the file with the descriptions to Anne Koehler in Houston and cc Nella. Thanx for your help. Chris
Chris Dorland, can you please remove me from this distribution list?	Can you please remove me from this distribution list. I am now in East Power Trading in Houston. Thanx Chris Dorland
Is this the one I sent you?	Did I send you this?
I live in the Westin hotel and untill my shit gets here, I am a resident.	Untill my shit gets here I am a resident of the Westin hotel.
I have to get some things done tonight and I would appreciate it if you could give me a shout at work.	Sorry I didn't get back to you. I have to run some errands tonight. Give me a shout at work tommorow. 974-6910 Chris
I don't know if we are going at 6 or 6:30.	Are we going at 6 or 6:30. I don't care.
Canterra Tower is located at 400 3rd Ave. SW in CALGARY, CANADA T2P 4H2.	3500 Canterra Tower 400 3rd Ave. SW Calgary, Alberta Canada T2P 4H2
I want to golf this weekend if Rod doesn't, so let me know if we have times.	I would like to golf both days this weekend. Do we have times? Let me know I can try to book some if Rod hasn't.
Don't take that deal out until I look at it, Kathy, I think it is mine, but I only wrote it in my red book.	Kathy, Don't take that deal out until I look at it. I think it is mine but I forgot to write it in the blue FX book (I only wrote it in my red book). Thanx, Chris
I didn't get to talk to Paul today, so I'm asking tommorow to give him a call.	I didn't get a chance to talk to Paul today. Give him a call tommorow. Chris
I would appreciate it if you could send the Visa documents to my office.	Margaret, Could you send the Visa documents to my office: Enron Canada Corp. 3500 Canterra Tower 400 - 3rd Ave. SW Calgary, AB T2P 4H2 Thanx, Chris Dorland
The report was written by remax.	remax wrote the report
1	1
I'm making some money, but what do you think about the stock market?	What's going on? Making some $? I having a pretty good month. What do you think of the stock market? I am practically all cash and Enron. Thinking of buying some TD and Royal Bank. Any great ideas? Chris
It is going to be okay, I am going to a lake resort with the guys in our group and all their wives and kids.	Bastard. This weekend I am going to a lake resort north of Houston with the guys in our group ( and all their wives and kids). Should be OK. Say Hi to all the boys. Chris
The girl in my dreams.	The girl of my dreams.
Chris Dorland said he cannot seem to suspend his product without hitting the red hand button, which is not an option when I right click on the product and not red stop light.	I cannot seem to suspend my product without hitting the red hand button (not an option when I right click on the product and not red stop light). thanx Chris Dorland
When the jury has started to deliberate, be sure to call your brother.	Call your brother when the jury has convened.
I'm wondering if I can transfer the assets from Clarica to you.	My pension and group RRSP is with Clarica. Can I transfer those assets to you? Chris
I invited him even though I didn't think he would come.	I actually invited him thinking there was no way he would come. Damn
Thank you very much!	Thank you!
At 10:00am, I didn't want to play golf.	No golf for me at 10:00am.
Ian has suffered severe mental strain because of this crime and he's requesting that the person who took his potatoe salad come forward.	Could the person who stole Ian Cooke's potatoe salad from the fridge please come forward. He has suffered severe mental strain due to this crime. Thanx Trading Group
Please, Dan, I need you to set up my direct line on my turrett today.	Dan, Could you set up my SDI direct line on my turrett today please. Chris
The stock option line item on my pay stub has a number of 36000, but I don't know if it's accurate.	Tricia, Have you looked in to the stock option line item on my pay stub yet? The number on the stub is about 36000 and I think about 18000 is accurate. Chris
Chris, what's the plan for Thursday night?	John What is the plan for Thursday night? Chris
We are going to hit the whiskey on Saturday and I want to ask you how you made out on Saturday.	that is some funny shit. how did you make out on saturday? I bailed and went home. we are going to hit the whiskey on saturday. should be good. talk to you later. chris
Have you had the boards out yet? I need a snow report, what's up? Better hop, but keep in touch.	What's up? How are things? Have you had the boards out yet? I need a snow report. Hope all is well. Better hop but keep in touch. cd
I am exhausted today and think I set a land speed from Fort Mac to CALGARY yesterday.	Happy belated B-Day! How was the party? I am so tired today. Too much driving. I think I set a land speed from Ft. Mac to Calgary yesterday. Chris
I wonder if she was the one coming back from lunch as I was leaving.	Was she the one coming back from lunch as I was leaving?
I was just making a joke, but I might buy you a cup of coffee if you're lucky.	I was just kidding. How desperately do you need them? Tonight I will be around in the evening. If you are lucky I might even buy you a cup of coffee.
Thank you.	Thanx.
There is silver and black in the interior.	Silver with Black interior.
Go to www.gwoods.com.	www.garrisonwoods.com
It is thnx.	thnx
Chris, do you know the phone number of the doctor's office?	TJae do you know the phone number for the doctor's office? Thanx Chris
Chris Dorland would like to thank you.	Thank you. Chris Dorland 5151 Edloe St. #14306 Houston, TX 77005
Kathy, could you run a mini book of the deals in my book? I'm setting up a new model and I want to double check that I have all the correct deals.	Kathy, Could you run a mini-book of all the deals in my FX book as of today. I am setting up a new model and want to double check that I have all the correct deals. Thanx, Chris
I would like to set up a trade with Chris Dorland.	I would like to get set up the trade the Nymex spread products on EOL. ADM92764 Thanx Chris Dorland
George has Oyster Creek coming back November 25. We have it coming back Nov. 17 on our sheet, assuming George's info is the best.	George has Oyster Creek coming back Nov. 25. We have it coming back Nov. 17 on our sheet. Let's assume George's info. is the best. Thanx, Chris
I just thought I would say hello, I'm bored, and you're working on the beautiful holiday Monday.	I don't suspose you are working on the beautiful holiday monday but I just thought I would say hi. I am so bored! As soon as the Nymex settles I am getting out of here. Chris
I will not forget about the $.	Jai Hawker 974-6721 I won't forget about the $.
Mom loves me more than you do.	mom loves me more than you
I need the eol technology, can you let me know what you have in the "model" spread sheet?	Russell, Can you e-mail me the "model" spread sheet. I want the eol technology. Chris
I'll take 2 tickets for the Feb. 25th game against Phoenix Chris.	Angela, I'll take the 2 tickets for Feb. 25 th vs. Phoenix Chris
I will try to give you a call tonight or on the weekend, as I am Dusting off my cowboy hat and going stampeding tomorrow.	Hope work is going well. Dusting off my cowboy hat and going stampeding tomorrow. I'll try to give you a call tonight or on the weekend. Say hi to MH and Wilson and Charlene. Chris
The idea is good and I will let Rod know if he has any other suggestions.	Good idea. I'll e-mail Rod and see if he has any other suggestions. Chris
It sounds like a marriage to me.	sounds like marriage to me....
The picture did not come through, is there a place on the web where I can see it?	Picture didn't come through. Sounds nice. Is there somewhere on the web I can see it. Chris
I've been busy and I apologize. I will send you a reply soon.	Sorry I haven't responded. I left early yesterday and have been big time busy today. I am still pretty sick. I'll write back soon.
I'm out of the office for most of Monday but I'll call you on Tuesday to let you know how I'm doing.	Keith, How was Portland? I'm out of the office moving most of Monday but I'll give you a call on Tuesday. Did you get a chance to drop of my keys at the rental office? Chris
You're Houston real estate...	Yours Houston real estate...
Three Task Due On: Task Start Date.	TASK ASSIGNMENT Task Priority: 3 Task Due On: Task Start Date:
I want to thank you.	Thank you.
I have a mortgage with a closing interest rate of 5.2%.	My one year closed interest rate on my mortgage is 5.2%. Not bad!
Just to chat, Chris, grab me when you have a moment.	Derek, Grab me when you have a minute. Just to chat. Chris
You don't need to keep offering in a falling market if you used a market or limit order.	Did you use a market or limit order? You don't need to lift offers in a falling market.
It was a nice ring on the phone.	Nice ring on the cell phone.
Do you have an agreement regarding the time you're going to be home?	Would you like to buy some $84 ENE Calls? How is you day going? Did you come to an agreement regarding your trip? Let me know what time you are going to be home tonight and I'll give you shout. Chris
I was thinking of buying my dad a gift for Father's day, but any suggestions? Be sure to let Christina know that I hope that she is feeling better.	Rod, I was thinking of buying my dad some cd's for father's day. Any suggestions? Be sure let Christina know I hope that she is feeling better. Chris
I will drop off the forms when you have a minute, please let me know, I will complete all the forms for you.	Tricia, I have completed all the forms you need. Let me know when you have a minute and I will drop them off. Chris
Looking good after it was closed.	Looking good. Closed at 40.25
It's a new plan, and you can call me if you want to go to Earl's.	New plan. Staying in Calgary. Want to go to Earl's? Call Me!
Chris, thank you for trying, that's fine.	That's fine. Thanx for trying. Chris
Thanx a lot.	Thanx
Milly's party will be able to be attended by me.	I will be able to attend Milly's party.
It wasn't that bad, even though I had to walk in the snow at 7. Lavo is moving to Houston.	No problem. The walk to work in the snow was invigorating at 6:45. Just kidding, it wasn't that bad. Big news around here today. Lavo is moving to Houston. Chris
My dad booked a tee time for Saturday at 1:44pm.	Dad, I booked a tee time for Saturday at 1:44pm. Chris
I'm not sure if the cost of pending lawsuits is priced into the stock.	Thanx I guess the question is whether the cost of pending lawsuits is priced into the stock? I see an RJR Nabisco deal here. Break off Miller and Kraft and let the death merchant division die slowly. Chris
Give me a call, Ryan, I want to know what's going on.	Ryan, What's going on? Give me a call at home. 214-0454 Talk to you later. Chris
The Aeco Basis is working again.	Basis snapping in. Wow. Long Oct. Aeco Basis works again. Nov-Mar is like 5 cents tighter today. You guys making some $ ?
I can't get anything else like this...	I can't get any more than this...
I'm in town on Thursday/Friday and we're planning on having a Thursday night playstation session with Johnny.	I am in town next Thursday/Friday. We should do a Thursday night playstation session with Johnny. Chris
Don't forget about the O'connors chick.	don't forget about O'connors chick
I left you a voice mail message after I e-mailed you the address I used for my mail stop.	Rebecca, My mail stop is EB 3125A. I e-mailed you that info. on Oct.30 and left you a voice mail message. CD
Let's look at them.	Whatever. Let me look at them.
Are you looking for analysts to work for the Toronto office? I know someone who would be a good fit.	Are you guys looking to hire any analysts for the Toronto office? I know someone I think would be a good fit. Let me know. Chris
A report will be issued by GS that says ENE is worth $68 a share.	Apparently GS is going to issue a report saying ENE is worth $68 a share. Chris
I did not get my spreadsheet from Friday, I would like to have the actual deals, but I used the average of my buy and sell from stack manager in my model.	Dianne, I didn't get my spreadsheet from Friday. No biggie I just used the average of my buy and sell from stack manager in my model but I would like to have the actual deals. Thanx, Chris
Do you know if any other newpaper publishes a synopsis of the same report? I think Red Deer might be and even better buy.	If any other newpaper publishes a summary of the same report will you please send it to me. Just kidding. Going to MLS listings right now to look for good investment properties. I think Red Deer might be and even better buy.
I received a reward for my hard work.	I got rewarded for hard work.
Did you receive her address?	Did you get her address?
Come on.	Come on. Sign into IM.
Sherry, thank you.	Thanx Sherry
Go ahead and make whatever adjustments you have to, Chris, I was just yanking your chain.	I was just yanking your chain. Deep breaths. Go ahead and make whatever adjustments. Chris
John and Chris, you need to respond to this issue.	John, I need a response on this issue. Chris
Work location is 403-214-7454 and Red Deer, 403-343-7086.	Home 403-214-0454 Work 403-974-6910 Red Deer 403-343-7086
I'm working on it and the Liquidity is a little thin.	I'm working it. Liquidity is a little thin. CD
I'll stop by and see you on Saturday night if you mention it.	Sounds good. If you talk to Heather Flemming or any one else mention Saturday night. I have to pick up some jeans at Underground so I will stop by and visit you tommorow. Chris
Someone sent me the wrong email.	Accidentally sent to me. chris.dorland@enron.com
It was not good when dailies traded down to 85 bucks at the end of the day.	Not good. Listen to this. At the end of the day dailies traded down to 85 bucks. Check that range 85-275. I need a vacation.
Chris will be able to attend, and I will be able to attend as well.	I will be able to attend. Chris
I can deal with 3 songs, that's what I can deal with.	3 songs. I can deal with that.
I was expecting you to like that. We had been working the homeboy language all week in the broker market.	I thought you would like that. We've been working the homeboy language in the broker market all week. You diss'n me? I'll bust a cap in your ass.
I lost my address book, but I was able to send an e-mail.	I would e-mail rod but fucking outlook lost my address book. Do you have his e-mail.
I have not done a trade in over an hour.	Thanx. I haven't done a trade in over an hour.
Does anyone know if I need to change my parking to Canterra from Ernst and Young?	Carla, Any word on changing my parking to Canterra from Ernst and Young? Chris
What's your name on your hotmail account?	What is your hotmail nickname?
It's quiet and I like the area. I didn't have a carrot cake but the soup was great.	I like that area. Nice and quiet. 6 blocks to Original Joe's. Didn't have the carrot cake but the soup was excellent.
No.	no
I need to make a call at home tonight.	Give me a call at home tonight. I just got a call from Lavo. Chris
It is possible to send it at any time during the day.	You can send it at any time during the day. Thanx, Chris Dorland
There's leather, limited slip differential, and window tint that reflects heat, plus no tax.	Mine has leather, limited slip differential and special window tinting that reflects heat. Plus no tax.
Thanks for the address, Nav. I think I'm not going to take it after seeing how hard he went through.	Thanx for Nav's address. Congrats on the CFA. Cowan just finished level 2. I don't think I'm going to take it after watching the hell he went through. Chris
Please make sure the settlement date and direction of the deal are entered correctly when checking my deals, they are entered from a US dollar perspective.	Scott, When checking my FX new deals please make sure the following are entered in my model correctly: Settlement Date FX Rate Dollar amount (All deals are entered from a US dollar perspective) Direction (buy/sell) Thanx, Chris
I need to save you e-mail if you reply to this.	Ryan, What's up? Reply to this so I can save you e-mail. I'll write more later. Chris
I will be coming home on Sunday, November 26th, and I will be leaving on Thursday, November 23rd.	Dad, US Thanksgiving is November 23/24. I will be coming home the night of Nov.22 and leaving on Sunday Nov. 26. Chris
The stock of Enron Corp. was up 17.8% as of 1 5/8.	Enron Corp. up 1 5/8
In the flesh in the throes of a flesh-eating disease.	In the flesh.
Chris would really like to see the weather up here.	Any progress on our access. We would really like to get a look at the weather up here. Chris
