1.05/1.35 is the rate at which it will be read on this date, Monday, January 14th, 1919, and is the age at which it will be read on this date, Monday, January 14th, 1919, and is the age at which it will be read	1.05/1.35
Flecther Sturm should be able to sell options.	Please enable Flecther Sturm to sell options
Maybe you would like this!	maybe you would enjoy this!
I wanted to make you aware of being out sick Friday and rescheduling.	Did you get my message concerning being out sick Friday and rescheduling?
I'm in the process of taking a course at an internet university and I'm having a website blocked from my computer. Please let me know when this can be fixed.	The site I have just been blocked from is a on-line mailbox at an internet university I am taking a course at: American Military University. Please let me know when this can be removed. Thank You Larry May 3-6731
I forgot to tell you that I had my dentist appointment at 3 pm, but I can meet on any other day this week.	Sorry for the late notice, I forgot I had a dentist appointment at 3:00, I can meet any other day this week. Thanks Larry
Maybe you would like this!	maybe you would enjoy this!
I'll call you at home tonight, I've got it.	I got it I'll call you at home tonight
I guess I need to change my password on ljmenron.	I'm on ljmenron (guess I should change it)
If you would like to contact me, call 713 853-6731 or 717 502-3576.	Give me a call 713 853-6731 or 713 502-3576
I will be at my dentist's office in the Post Oak area at 400pm.	I have a dental appointment in the Post Oak area at 400pm. I can meet until 410 or so.
Susan will work at your desk full-time, so she will be able to help a replacement with his problems until he is completely comfortable.	It"s my understanding that Susan will work for your desk full-time. She has offered, time permiting, to help her replacement with problems until he is completely comfortable.
You should take swap and options classes if you want to pass this on to Brad.	Pass this on to Brad as well, I think you guys should take the swap and options classes.
Yes, thank you.	Yes, thanks
Are you there right now?	Are you down there now?
Larry May will be at the event.	I will attend. Larry May x6731
Larry, could you please take care of my application for Enron Online?	Could you please take care of my application for Enron Online Thanks, Larry
You are welcome, and I would like to thank you for your help at work.	you are welcome, and thank you for all your help at work.
Number 12 is used in the Transco Zone 6.	Use number 12: Transco Zone 6
Can you find one that's similar to this one?	Could you find one please
Thank you for taking the time to say thank you.	THANK YOU
We can find a conference room today at 3pm.	how about today (Thurs) 3pm we can find a conference room
I'll let you know about it tomorrow.	I'll talk to you about it tomorrow. Thanks Larry
Lance Jordan and Eric Sandberg are the two people who give gas daily options.	For gas daily options it is Eric Sandberg and Lance Jordan
Yes, I do.	YES
What is it that you call yourself?	What is your im name
It's what I expected. Thanks Larry.	It is what I expected, Thanks Larry
